mindestens	Adverb	
darüber	Adverb	
daher	Adverb
genauso	Adverb	
sonst	Adverb	
zuletzt	Adverb	
dabei	Adverb	
selbst	Adverb	
jedenfalls	Adverb	
einmal	Adverb	
allein	Adverb	
meistens	Adverb	
dazu	Adverb	
selber	Adverb	
bereits	Adverb	
durchaus	Adverb	
damit	Adverb	
kaum	Adverb	
zuerst	Adverb	
nun	Adverb	
jedoch	Adverb	
besonders	Adverb	
außerdem	Adverb	
überhaupt	Adverb	
noch	Adverb		
wieder	Adverb		
schon	Adverb		
zu	Adverb		
vielleicht	Adverb		
dran	Adverb		
genug	Adverb		
nur	Adverb		
so	Adverb	
auch	Adverb		
alleine	Adverb		
immer	Adverb		
zusammen	Adverb
gern	Adverb		
gerne	Adverb	
plus	Adverb	
bitte	Adverb	
nicht	Adverb		
zurück	Adverb	
rechts	Adverb	
her	Adverb	
weg	Adverb	
heraus	Adverb	
herum	Adverb	
links	Adverb	
hinaus	Adverb	
hin	Adverb	
unterwegs	Adverb	
voraus	Adverb	
herein	Adverb	
raus	Adverb	
hierher	Adverb	
rein	Adverb	
gratis	Adverb	
manchmal	Adverb		
gar	Adverb	
weniger	Adverb	
oft	Adverb	
je	Adverb	
meist	Adverb	
dort	Adverb	
oben	Adverb	
hinten	Adverb	
überall	Adverb	
da	Adverb	
außen	Adverb	
drüben	Adverb	
hier	Adverb	
innen	Adverb	
nebenan	Adverb	
vorne	Adverb	
draußen	Adverb	
unten	Adverb	
drinnen	Adverb
nie	Adverb	
niemals	Adverb	
herunter	Adverb
nachts	Adverb	
morgen	Adverb	
fast	Adverb	
sofort	Adverb	
lange	Adverb	
damals	Adverb	
dann	Adverb	
jetzt	Adverb	
heute	Adverb	
gerade	Adverb
etwa	Adverb	
gestern	Adverb	
spätestens	Adverb	
bald	Adverb	
endlich	Adverb	
inzwischen	Adverb	
danach	Adverb	
vorbei	Adverb	
irgendwo	Adverb
warum	Adverb	
wann	Adverb			
wohin	Adverb	
wo	Adverb
woher	Adverb	
womit	Adverb	
wofür	Adverb	
worüber	Adverb	
wieso	Adverb	
leider	Adverb	
ja	Adverb	
nein	Adverb	
anders	Adverb	
daran	Adverb		
ganz	Adverb	
davon	Adverb	
zuvor	Adverb
vorher	Adverb	
insbesondere	Adverb	
hiermit	Adverb	
weiterhin	Adverb	
nochmals	Adverb	
derzeit	Adverb	
natürlich	Adverb	
sehr	Adverb		
ziemlich	Adverb	
irgendwie	Adverb	
dennoch	Adverb	
hingegen	Adverb	
mittlerweile	Adverb	
deswegen	Adverb	
hierzu	Adverb		
mal	Adverb	
normalerweise	Adverb	
eher	Adverb		
irgendwann	Adverb
ebenfalls	Adverb	
schließlich	Adverb	
hinzu	Adverb	
jederzeit	Adverb	
soeben	Adverb	
zumindest	Adverb	
ansonsten	Adverb	
übrigens	Adverb	
zugleich	Adverb	
dadurch	Adverb	
allerdings	Adverb	
deshalb	Adverb	
also	Adverb	
wohl	Adverb
sogar	Adverb		
trotzdem	Adverb		
darum	Adverb		
dafür	Adverb	
darauf	Adverb	
soweit	Adverb	
bisher	Adverb	
eigentlich	Adverb	
wenigstens	Adverb	
drin	Adverb	

sowohl	Conjunction	
völlig	Adjective	
weder	Conjunction	

erneut	Adjective	
tun	Verb		
	
heiße	Adjective		
		
wirklich	Adjective		
	
telefonieren	Verb	
lernen	Verb	
großartig	Adjective	
acht	Numeral	
gleich	Adjective	

zwei	Numeral	
vier	Numeral	
drei	Numeral	
sieben	Numeral	
vierzig	Numeral	
geteilt durch		
zwölf	Numeral	
fünf	Numeral	
ist	Verb	
zehn	Numeral	
eins	Numeral	
minus	Preposition	
neun	Numeral	
harmlos	Adjective	
gefährlich	Adjective	
verrückt	Adjective	
reich	Adjective	
schweizer franken		
zeug	Noun	
ich	Pronoun	
mein	Pronoun	
haben	Verb	
habe	Verb	
wir	Pronoun	
frauen	Noun	

keine	Determiner	
alt	Adjective	
kein	Determiner	

bin	Verb	
schneit	Verb	
trocken	Adjective	
regnet	Verb	
nass	Adjective	
stärker	Adjective	
größer	Adjective	
höher	Adjective	
teurer	Adjective	
kleiner	Adjective	
langsamer	Adjective	
länger	Adjective	
schneller	Adjective	
besser	Adjective	
wichtiger	Adjective	
leichter	Adjective	
als	Conjunction	
schöner	Adjective	
dünn	Adjective	
dick	Adjective	
briefkasten	Noun

billig	Adjective	
mich	Pronoun	
ihn	Pronoun	
uns	Pronoun	
euch	Pronoun	
dich	Pronoun	
bisschen	Determiner	
mehr	Determiner	
keinerlei	Determiner	
desto	Conjunction	
selten	Adjective	
ob	Conjunction	

häufig	Adjective	

stolz	Adjective

total	Adjective	
tapfer	Adjective	
schlau	Adjective	
dumm	Adjective	
langweilig	Adjective	
lieber	Adjective	
unheimlich	Adjective	
nett	Adjective	
interessant	Adjective	
ehrlich	Adjective	
schlimm	Adjective	
witzig	Adjective	
gegenüber	Preposition	
	
voll	Adjective	
leer	Adjective	
glas	Noun	
	
sozialen	Adjective	
hoch		
keiner	Determiner	
keinen	Determiner	
fernsehen	Verb	
ähnlich	Adjective	
krank	Adjective	
notwendigen	Adjective	
passende	Adjective	
größte	Adjective	
passenden	Adjective	
weiterer	Adjective	
öffentliche	Adjective	
wichtigsten	Adjective	
größten	Adjective	
wichtigen	Adjective	
einzelnen	Adjective	
linken	Adjective	
besonderen	Adjective	
private	Adjective	
speziellen	Adjective	
richtige	Adjective	
zufälliger	Adjective	
normalen	Adjective	
eigener	Adjective	
neues	Adjective	
nächster	Adjective	
übrigen	Adjective	
internationalen	Adjective	
müde	Adjective	
aktuelle	Adjective	
alte	Adjective	
letzter	Adjective	
jugendliche	Adjective	
öffentlichen	Adjective	
internationale	Adjective	
höheren	Adjective	
hoher	Adjective	
hohen	Adjective	
neuen	Adjective	
gesamte	Adjective	
gelb	Adjective	
weiß	Adjective	
bunt	Adjective	
grün	Adjective	
grau	Adjective	
braun	Adjective	
rot	Adjective	
blau	Adjective	
pink	Adjective	
schwarz	Adjective	
verheiratet	Adjective	
schwanger	Adjective	
	
früh	Adjective	
später	Adjective	

spät	Adjective	
viertel	Verb	

halb	Adjective	
bäckerin	Noun	
köche	Noun	
beruf	Noun	
arzt	Noun	
koch	Noun	
ärztin	Noun	
bäcker	Noun	
köchinnen	Noun	
ärztinnen	Noun	
ärzte	Noun	
brot	Noun	
isst	Verb	
beim	Preposition	
sind	Verb	
und	Conjunction	
bist	Verb	
schlecht	Adjective	
du	Pronoun	
meine	Pronoun	
mit	Preposition	
die	Determiner	
toll	Adjective	
mädchen	Noun	
gehen	Verb	
schwimmen	Verb	

wöchentlich	Adjective	

bis	Preposition	

täglich	Adjective	
heiß	Adjective	
jährlich	Adjective	
	
monatlich	Adjective	
kühl	Adjective	
legt	Verb	
in	Preposition	
legen	Verb	
auf	Preposition	
aufs	Preposition	
den	Determiner	
kinder	Noun	
buch	Noun	
meiner	Pronoun	
dem	Determiner	
vögel	Noun
er	Pronoun	
im	Preposition	
das	Determiner	
kind	Noun	
nach	Preposition	
für	Preposition	

es	Pronoun	
einen	Determiner	
habt	Verb	
etwas	Pronoun	
hast	Verb	
aus	Preposition	
essen	Verb	
alles	Determiner	
scharf	Adjective	
sauer	Adjective	
salzig	Adjective	
zu abend		
zu mittag		
dreizehn	Numeral	
sechzehn	Numeral	
achtzehn	Numeral	
elf	Numeral	
fünfzehn	Numeral	
dutzend	Noun	
es gibt		
vierzehn	Numeral	
sechs	Numeral	
neunzehn	Numeral	
siebzehn	Numeral	

wie bitte		
wie viel

wie viele		
wie	Conjunction	
deine	Pronoun	
dein	Pronoun	
hat	Verb	
schön	Adjective	
frau	Noun	
durst	Noun	
weit	Adjective	
willkommen	Adjective	
mann	Noun	
schwer	Adjective	
sauber	Adjective	
kurz	Adjective	
gesund	Adjective	
lustig	Adjective	
traurig	Adjective	
einfach	Adjective	
fertig	Adjective	
oder	Conjunction	
entweder	Conjunction	
dass	Conjunction	
denn	Conjunction	
wenn	Conjunction	
sobald	Conjunction	
weil	Conjunction	
obwohl	Conjunction	
doch	Conjunction	
solange	Conjunction	
aber	Conjunction	
sondern	Conjunction	
hundert	Numeral	
zweiundachtzig	Numeral	
dreißig	Numeral	
zweiundvierzig	Numeral	
tausend	Numeral	
einundzwanzig	Numeral	
hundertdreiundzwanzig	Numeral	
sechzig	Numeral	
achtzig	Numeral	
zwanzig	Numeral	
fünfzig	Numeral	
dreiundzwanzig	Numeral	
vierundzwanzig	Numeral	
achtundzwanzig	Numeral	
siebzig	Numeral	
zweiunddreißig	Numeral	
neunzig	Numeral	
decken	Noun	
türen	Noun	
zaun	Noun	
zäune	Noun	
treppe	Noun	
tür	Noun	
wand	Noun	
fenster	Noun	
wände	Noun	
sie	Pronoun	
neu	Adjective	
groß	Adjective	
lang	Adjective	
klein	Adjective	
ruhig	Adjective	
leise	Adjective	
rund	Adjective	
normal	Adjective	
klar	Adjective	
laut	Adjective	
leicht	Adjective	
perfekt	Adjective	
schwach	Adjective	
frei	Adjective	
stark	Adjective	
schmutzig	Adjective	
richtig	Adjective	
warm	Adjective	
wichtig	Adjective	
schnell	Adjective	
kalt	Adjective	
jung	Adjective	
langsam	Adjective	
tief	Adjective	
teuer	Adjective	
bären	Noun	
mäuse	Noun	
enten	Noun	
kühe	Noun	
zeitung	Noun	
trinke	Verb	
esst	Verb	
lese	Verb	
trinken	Verb	
trinkst	Verb	
liest	Verb	
trinkt	Verb	
lesen	Verb	
esse	Verb	
milch	Noun	
schwein	Noun	
süß	Adjective	
frisch	Adjective	
schmeckt	Verb	
hunger	Noun	
lecker	Adjective	
gut	Adjective	
eis	Noun	
hans	Proper noun	
deutsch	Noun	
englisch	Noun	
männer	Noun	
jungen	Noun	
seid	Verb	
bis morgen		
danke	Interjection
gute nacht		
genau		
in ordnung		
gern geschehen		
guten tag		
bis später		
tschüss	Interjection	
es tut mir leid	

auf wiedersehen		
guten abend		
wie geht's		
alles klar		
guten morgen		
bis bald		
mir geht's gut		
keine ahnung		
hallo	Interjection	
wirklichkeit	Noun	
bewusstsein	Noun	
bei	Preposition	
wahr	Adjective	
falsch	Adjective	
ein	Determiner	
philosophie	Noun	
dir	Pronoun	
pessimist		
skeptisch		
ihnen	Pronoun	
optimist		
mir	Pronoun	
ihm	Pronoun	

passiert	Adjective	

eine	Determiner	
durch	Preposition	
paar	Determiner	
ohne	Preposition	
ihr	Pronoun	
heutigen	Adjective	
privaten	Adjective	
meinen	Pronoun
	
von	Preposition	
schenkst	Verb	
schenkt	Verb	
schenken	Verb	
gesamten	Adjective	
bekannten	Adjective	
zweiten	Adjective	
einer	Determiner	
deutschen	Adjective	
am	Preposition	
wertvoll	Adjective	
vorsichtig	Adjective	
um	Preposition	
geschehen	Verb	
beendet	Adjective	
zum	Preposition
nachdem	Conjunction	
	
bevor	Conjunction	
	
köpfe	Noun	
feuerzeuge	Noun	
feuerzeug	Noun	
haare	Noun	
auge	Noun	
fahrzeug	Noun	
weitere	Adjective	
zuständigen	Adjective	
gleiche	Adjective	
einzige	Adjective	
offenen	Adjective	
modernen	Adjective	
gemeinsame	Adjective	
ehemaligen	Adjective	
höhere	Adjective	
zweite	Adjective	
verschiedene	Adjective	
vergangenen	Adjective	
verschiedenen	Adjective	
eigenen	Adjective	
hohe	Adjective	
persönlichen	Adjective	
ganzen	Adjective	
komplette	Adjective	
eigene	Adjective	
weiteres	Adjective	
langen	Adjective	
technischen	Adjective	
detaillierte	Adjective	
kostenlose	Adjective	
nächsten	Adjective	
wichtige	Adjective	
verfügbaren	Adjective	
kindes	Noun	
mannes	Noun	
hauses	Noun	
des	Determiner	
der	Determiner	
falls	Conjunction	
schöne	Adjective	
eigenes	Adjective	
ehemalige	Adjective	
zusätzlichen	Adjective	
schönen	Adjective	
individuelle	Adjective	
persönliche	Adjective	
starke	Adjective	
alten	Adjective	
ähnlichen	Adjective	
neuesten	Adjective	
interessante	Adjective	
gleichen	Adjective	
politischen	Adjective	
höchste	Adjective	
externe	Adjective	
einfache	Adjective	
freien	Adjective	
starken	Adjective	
möglichen	Adjective	
aktive	Adjective	
unterschiedliche	Adjective	
nächste	Adjective	
einfachen	Adjective	
neue	Adjective	
gelber	Adjective	
öffentliches	Adjective	
letzten	Adjective	
zusätzliche	Adjective	
soziale	Adjective	
offene	Adjective	
günstige	Adjective	
soziales	Adjective	
heilig	Adjective	
hinduismus	Noun	
zur	Preposition	
seit	Preposition	
vom	Preposition	
international	Adjective	
positiv	Adjective	
unbekannt	Adjective	
selbstverständlich	Adjective	
individuell	Adjective	
bekannt	Adjective	
unsichtbar	Adjective	
abhängig	Adjective	
begeistert	Adjective	
sichtbar	Adjective	
verpflichtet	Adjective	
praktisch	Adjective	
kostenlos	Adjective	
nützlich	Adjective	
wahrscheinlich	Adjective	
eindeutig	Adjective	
unabhängig	Adjective	
verfügbar	Adjective	
notwendig	Adjective	
deutlich	Adjective	
persönlich	Adjective	
unmöglich	Adjective	
möglich	Adjective	
zufrieden	Adjective	
extrem	Adjective	
zuständig	Adjective	
sinnvoll	Adjective	
knapp	Adjective	
relativ	Adjective	
plötzlich	Adjective	
bereit	Adjective	
tatsächlich	Adjective	
fest	Adjective	
fit	Adjective	
aktiv	Adjective	
offen	Adjective	
egal	Adjective	
weich	Adjective	
verantwortlich	Adjective	
hilfreich	Adjective	
komplett	Adjective	
echt	Adjective	
original	Adjective	
beliebt	Adjective	
privat	Adjective	
allgemein	Adjective	
seltsam	Adjective	
kaputt	Adjective	
ausgezeichnet	Adjective	
automatisch	Adjective	
hart	Adjective	
gemeinsam	Adjective	
wert	Adjective	
regional	Adjective	
komisch	Adjective	
einem	Determiner	
meinem	Pronoun	
namen	Noun	
person	Noun	
dame	Noun	
herren	Noun	
leute	Noun	
damen	Noun	
freundin	Noun	
freund	Noun	
babys	Noun	
junge	Noun	
entlang		
gegen	Preposition	
wind	Noun	
baum	Noun	
natur	Noun	
berge	Noun	
bäume	Noun	
see	Noun	
strände	Noun	
bernstein	Noun	
welle	Noun	
welt	Noun	
strand	Noun	
wellen	Noun	
verspätung	Noun	
fliegst	Verb	
bucht	Verb	
buche	Verb	
fähre	Noun	
bushaltestelle	Noun	
besuch	Noun	
schweden	Noun	
fähren	Noun	
wandert	Verb	
wanderst	Verb	
großbritannien	Proper noun	
tour	Noun	
boot	Noun	
bahn	Noun	
boote	Noun	
abenteuer	Noun	
bahnen	Noun	
strecken	Noun	
strecke	Noun	
motorrad	Noun	
motorräder	Noun	
fahrt	Noun	
mietwagen	Noun	
schweiz	Proper noun	
schweizer	Noun	
verkehr	Noun	
wen	Pronoun	
antworten	Noun	
wessen	Pronoun	
wem	Pronoun	
wer	Pronoun	
antwort	Noun	
pilz	Noun	
hähnchen	Noun	
tomate	Noun	
mittagessen	Noun	
pilze	Noun	
äpfel	Noun	
käfer	Noun	
erdbeeren	Noun	
orangen	Noun	
fliegen	Noun	
katzen	Noun	
spinnen	Noun	
tomaten	Noun	
bananen	Noun	
menschen	Noun	
zeitungen	Noun	
eier	Noun	
kartoffeln	Noun	
insekten	Noun	
frist	Noun	
kreditkarten	Noun	
kontos	Noun	
beziehung	Noun	
familie	Noun	
eltern	Noun	
beziehungen	Noun	
partner	Noun	
geschwister	Noun	
familien	Noun	
gründe	Noun	
bezirk	Noun	
bezirke	Noun	
region	Noun	
regionen	Noun	
grund	Noun	
bundesland	Noun	
standorte	Noun	
standort	Noun	
flughafen	Noun	
stadtplan	Noun	
sehenswürdigkeiten	Noun	
flug	Noun	
taxi	Noun	
flüge	Noun	
tourismus	Noun	
wege	Noun	
sehenswürdigkeit	Noun	
reiseführer	Noun	
spanien	Proper noun	
dorf	Noun	
parks	Noun	
brücken	Noun	
dörfer	Noun	
bauen	Verb	
zimmer	Noun	
plätze	Noun	
wohnst	Verb	
bereich	Noun	
bereichen	Noun	
wohnen	Verb	
ort	Noun	
unterkunft	Noun	
platz	Noun	
wohnt	Verb	
kneipe	Noun	
wohne	Verb	
pässe	Noun	
afrika	Proper noun	
visum	Noun	
reise	Noun	
pass	Noun	
hamburg	Proper noun	
ferien	Noun	
frankreich	Proper noun	
reisen	Noun	
tochter	Noun	
müttern	Noun	
töchter	Noun	
vater	Noun	
mutter	Noun	
schwestern	Noun	
mütter	Noun	
schwester	Noun	
sohn	Noun	
fische	Noun	
tiere	Noun	
schweine	Noun	
hunde	Noun	
was	Pronoun	
frage	Noun	
fragen	Noun	
bank	Noun	
hotels	Noun	
schloss	Noun	
banken	Noun	
bibliotheken	Noun	
restaurants	Noun	
restaurant	Noun	
bahnhöfe	Noun	
bibliothek	Noun	
hotel	Noun	
butter	Noun	
marmelade	Noun	
nüsse	Noun	
frühstücke	Verb	
frühstückt	Verb	
frühstück	Noun	
frühstückst	Verb	
müsli	Noun	
nuss	Noun	
frühstücken	Verb	
fliege	Noun	
insekt	Noun	
biene	Noun	
kuh	Noun	
haustier	Noun	
pferd	Noun	
vogel	Noun	
bär	Noun	
tier	Noun	
hund	Noun	
maus	Noun	
katze	Noun	
ecken	Noun	
schulen	Noun	
häuser	Noun	
gebäude	Noun	
gärten	Noun	
markt	Noun	
bezahlen	Verb	
reicht	Verb	
brauchen	Verb	
wäschst	Verb	
bezahlt	Verb	
bezahle	Verb	
beginne	Verb	
beginnen	Verb	
bezahlst	Verb	
brauche	Verb	
waschen	Verb	
beginnt	Verb	
wäscht	Verb	
bringt	Verb	
denkst	Verb	
rennt	Verb	
fahren	Verb	
kennst	Verb	
fahre	Verb	
kenne	Verb	
schwimmst	Verb	
denke	Verb	
kennt	Verb	
fährt	Verb	
schwimme	Verb	
schwimmt	Verb	
rennen	Verb	
bringe	Verb	
schreibst	Verb	
lernst	Verb	
seht	Verb	
mögt	Verb	
schreibt	Verb	
hörst	Verb	
hört	Verb	
lernt	Verb	
mögen	Verb	
mag	Verb	
magst	Verb	
machen	Verb	
schläfst	Verb	
spielen	Verb	
wollen	Verb	
spielst	Verb	
mache	Verb	
will	Verb	
laufen	Verb	
schlafe	Verb	
spielt	Verb	
schläft	Verb	
überweise	Verb	
überweist	Verb	
geldautomat	Noun	
geldautomaten	Noun	
kauft	Verb	
kaufe	Verb	
euros	Noun	
kaufen	Verb	
cents	Noun	
kaufst	Verb	
kostet	Verb	
cent	Noun	

fahrrad	Noun	
bus	Noun	
autos	Noun	
urlaub	Noun	
wien	Proper noun	
bayern	Proper noun	
zug	Noun	
busse	Noun	
fahrräder	Noun	
österreich	Proper noun	
auto	Noun	
außer	Preposition	
wegen	Preposition	
einschließlich	Preposition	
an	Preposition	
ums	Preposition	
hinter	Preposition	
ab	Preposition	
neben	Preposition	
vor	Preposition	
während	Preposition	
unter	Preposition	
über	Preposition	
zwischen	Preposition	
ins	Preposition	
schlangen	Noun	
haie	Noun	
schlange	Noun	
man	Determiner	
huhn	Noun	
hörner	Noun	
wespe	Noun	
stechen	Verb	
horn	Noun	
delfine	Noun	
tiger	Noun	
wale	Noun	
schildkröten	Noun	
reitet	Verb	
reite	Verb	
zebras	Noun	
giraffen	Noun	
hamster	Noun	
pinguine	Noun	
kamele	Noun	
kamel	Noun	
pinguin	Noun	
viel	Determiner	
job	Noun	
bewerbung	Noun	
karrieren	Noun	
jobs	Noun	
kleinanzeigen	Noun	
karriere	Noun	
handel	Noun	
gewinne	Noun	
gewinn	Noun	
käufer	Noun	
werte	Noun	
käufe	Noun	
alle	Determiner	
dokument	Noun	
dokumente	Noun	
beitrag	Noun	
beiträge	Noun	
wettbewerb	Noun	
projekte	Noun	
projekt	Noun	
management	Noun	
bestellungen	Noun	
beratung	Noun	
kollege	Noun	
aktien	Noun	
aktie	Noun	
kollegen	Noun	
gebot	Noun	
mietet	Verb	
mieten	Verb	
zinsen	Noun	
rechnungen	Noun	
zahlungen	Noun	
münze	Noun	

taschenbücher	Noun	
radios	Noun	
anmeldung	Noun	
lautsprecher	Noun	
anmeldungen	Noun	
bestätigung	Noun	
postleitzahl	Noun	
kontakte	Noun	
briefmarke	Noun	
boden	Noun	
paket	Noun	
stück	Noun	
stücke	Noun	
geschenk	Noun	
geschenke	Noun	
stellen	Noun	
sache	Noun	
plan	Noun	
produkt	Noun	
produkte	Noun	
schere	Noun	
katalog	Noun	
produkten	Noun	
scheren	Noun	
sachen	Noun	
lege	Verb	
therapie	Noun	
diät	Noun	
ernährung	Noun	
klinik	Noun	
zahnarzt	Noun	
notfälle	Noun	
schlechte	Adjective	
opfern	Noun	
unfälle	Noun	
zahnärztin	Noun	
notfall	Noun	
opfer	Noun	
krankenversicherung	Noun	
krankenwagen	Noun	
krankenwägen	Noun	
krankenhaus	Noun	
krankenhäuser	Noun	
medizin	Noun	
ahnung	Noun	
naja	Interjection	
verzeihung	Noun	
untersuchungen	Noun	
gesundheit	Noun	
formulare	Noun	
formular	Noun	
praxis	Noun	
untersuchung	Noun	
blute	Verb	
patient	Noun	
bluten	Verb	
patienten	Noun	
rollstuhl	Noun	
pflaster	Noun	
blutet	Verb	
medikament	Noun	
erziehung	Noun	
prüfungen	Noun	
kindergärten	Noun	
überlege	Verb	
überlegst	Verb	
fachbereich	Noun	
weiterbildung	Noun	
prüfung	Noun	
uni	Noun	
kindergarten	Noun	
schmuck	Noun	
knöpfe	Noun	
ring	Noun	
fleck	Noun	
passt	Verb	
taschen	Noun	
kosmetik	Noun	
ringe	Noun	
flecken	Noun	
tasche	Noun	
hose	Noun	
kleidung	Noun	
jacke	Noun	
mantel	Noun	
hosen	Noun	
jacken	Noun	
hemden	Noun	
mäntel	Noun	
hemd	Noun	
bildern	Noun	
bild	Noun	
löscht	Verb	
bilder	Noun	
lösche	Verb	
löschst	Verb	
schuhe	Noun	
tragen	Verb	
röcke	Noun	
trägt	Verb	
kleid	Noun	
trage	Verb	
kleider	Noun	
hut	Noun	
hüte	Noun	
schuh	Noun	
tragt	Verb	
rock	Noun	
handtücher	Noun	
duschen	Noun	
handtuch	Noun	
dusche	Noun	
duschgel	Noun	
duscht	Verb	
bad	Noun	
duschst	Verb	
spiegel	Noun	
kühlschrank	Noun	
rucksäcke	Noun	
tassen	Noun	
tasse	Noun	
teller	Noun	
batterie	Noun	
hochschule	Noun	
institute	Noun	
lehre	Noun	
institut	Noun	
unterricht	Noun	
training	Noun	
ausbildung	Noun	
hochschulen	Noun	
geräte	Noun	
haushalt	Noun	
gerät	Noun	
lache	Verb	
lacht	Verb	
verständnis	Noun	
schulden	Noun	
lachen	Verb	
glück	Noun	
lieblings	Noun	
liebling	Noun	
böse	Adjective	
hasst	Verb	
hassen	Verb	
lust	Noun	
ärger	Noun

gedanken	Noun	
gedanke	Noun	
witz	Noun	
humor	Noun	
ruhe	Noun	
fünfte	Adjective	
sechste	Adjective	
siebte	Verb	
vierte	Adjective	
mathematik	Noun	
sammelt	Verb	
steigt	Verb	
stehlt	Verb	
prüfen	Verb	
prüft	Verb	
schaue	Verb	
fehlt	Verb	
stiehlt	Verb	
steigen	Verb	
sammeln	Verb	
schauen	Verb	
sammle	Verb	
meint	Verb	
fehlen	Verb	
dritte	Adjective	
erstes	Adjective	
erste	Adjective	
ersten	Adjective	
gehe	Verb	
handle	Verb	
lass	Verb	
ruf	Verb	
geht	Verb	
geh	Verb	
lasst	Verb	
nimm	Verb	
lest	Verb	
trink	Verb	
iss	Verb	
lies	Verb	
nehmt	Verb	
gebt	Verb	
akzeptiere	Verb	
abonniert	Verb	
akzeptiert	Verb	
funktioniert	Verb	
funktionieren	Verb	
spaziert	Verb	
spazieren	Verb	
abonnieren	Verb	
akzeptieren	Verb	
adressen	Noun	
briefe	Noun	
brief	Noun	
eindruck	Noun	
liebst	Verb	
liebt	Verb	
lieben	Verb	
angst	Noun	
spaß	Noun	
liebe	Verb	
ernst	Noun	
apotheken	Noun	
gutschein	Noun	
sonderangebot	Noun	
apotheke	Noun	
sonderangebote	Noun	
einkaufszentrum	Noun	
einkaufszentren	Noun	
richterinnen	Noun	
richter	Noun	
rechtsanwälte	Noun	
spezialität	Noun	
summe	Noun	
hälften	Noun	
zahl	Noun	
telefonnummer	Noun	
zahlen	Noun	
hälfte	Noun	
erweitere	Verb	
benutzen	Verb	
benutze	Verb	
erweitert	Verb	
erlauben	Verb	
übernimmt	Verb	
schließen	Verb	
benutzt	Verb	
erweitern	Verb	
ersetzen	Verb	
schließt	Verb	
werkstätten	Noun	
handwerk	Noun	
hersteller	Noun	
stellt	Verb	
steht	Verb	
stehe	Verb	
wartest	Verb	
stehen	Verb	
wartet	Verb	
trifft	Verb	
liegst	Verb	
liegt	Verb	
warten	Verb	
treffen	Verb	
stelle	Verb	
scheint	Verb	
halbbruder	Noun	
halbschwestern	Noun	
hochzeit	Noun	
halbbrüder	Noun	
partnerschaften	Noun	
halbschwester	Noun	
lampe	Noun	
ladegerät	Noun	
steckdosen	Noun	
ladegeräte	Noun	
schlafzimmer	Noun	
betten	Noun	
steckdose	Noun	
teppich	Noun	
bett	Noun	
lampen	Noun	
licht	Noun	
schränke	Noun	
stühlen	Noun	
tische	Noun	
schrank	Noun	
tisch	Noun	
sofa	Noun	
stühle	Noun	
wohnzimmer	Noun	
möbel	Noun	
sofas	Noun	
balkon	Noun	
wohnung	Noun	
dach	Noun	
dächer	Noun	
küchen	Noun	
schlüssel	Noun	
küche	Noun	
keller	Noun	
cousinen	Noun	
zwilling	Noun	
urenkel	Noun	
cousine	Noun	
zwillinge	Noun	
urgroßmutter	Noun	
cousins	Noun	
tüte	Noun	
kasse	Noun	
tüten	Noun	
kassen	Noun	
kunde	Noun	
einkaufswägen	Noun	
kunden	Noun	
supermarkt	Noun	
verwandten	Noun	
verwandte	Noun	
onkel	Noun	
nichten	Noun	
tanten	Noun	
neffen	Noun	
drucken	Verb	
passwörter	Noun	
druckt	Verb	
aktualisiert	Verb	
tasten	Noun	
kommentare	Noun	
schicken	Verb	
schickt	Verb	
suchmaschinen	Noun	
gewitter	Noun	
wolke	Noun	
blitze	Noun	
regenschirm	Noun	
blitz	Noun	
regenbogen	Noun	
donner	Noun	
sturms	Noun	
sturm	Noun	
entwickler	Noun	
träumen	Verb	
wunsch	Noun	
träumt	Verb	
wünsche	Noun	
not	Noun	
träume	Noun	
freude	Noun	
kupfer	Noun	
eisen	Noun	
metalle	Noun	
gold	Noun	
silber	Noun	
dauer	Noun	
arbeitserlaubnis	Noun	
organisation	Noun	
mitgliedschaften	Noun	
unternehmen	Noun	
fabrik	Noun	
inhaber	Noun	
mitgliedschaft	Noun	
fabriken	Noun	
klassen	Noun	
test	Noun	
forschung	Noun	
tests	Noun	
kurs	Noun	
seminar	Noun	
studium	Noun	
klasse	Noun	
seminare	Noun	
wunderschöne	Adjective	
gleichgewicht	Noun	
wunderbar	Adjective	
papier	Noun	
mauer	Noun	
papiere	Noun	
pappe	Noun	
mauern	Noun	
baumwolle	Noun	
anfang	Noun	
zukunft	Noun	
ende	Noun	
zeitpunkt	Noun	
mitternacht	Noun	
zeitpunkte	Noun	
lade	Verb	
lädt	Verb	
fotos	Noun	
foto	Noun	
füße	Noun	
beine	Noun	
brust	Noun	
magen	Noun	
schulter	Noun	
rücken	Noun	
brüste	Noun	
schultern	Noun	
universitäten	Noun	
noten	Noun	
grundschule	Noun	
stifte	Noun	
grundschulen	Noun	
note	Noun	
übungen	Noun	
stift	Noun	
übung	Noun	
stiften	Noun	
bildung	Noun	
universität	Noun	
niemand	Determiner	
bäckereien	Noun	
marktplätze	Noun	
läden	Noun	
bäckerei	Noun	
minute	Noun	
stunden	Noun	
sekunden	Noun	
augenblick	Noun	
sekunde	Noun	
zeit	Noun	
uhrzeit	Noun	
uhr	Noun	
zeiten	Noun	
uhren	Noun	
minuten	Noun	
abende	Noun	
nacht	Noun	
abend	Noun	
nächte	Noun	
mittag	Noun	
werktag	Noun	
sonntage	Noun	
woche	Noun	
wochen	Noun	
samstage	Noun	
mittwoch	Noun	
tage	Noun	
tag	Noun	
tagen	Noun
bleiben	Verb	
sucht	Verb	
findest	Verb	
nehmen	Verb	
nehme	Verb	
nimmt	Verb	
suchen	Verb	
ändert	Verb	
bleibe	Verb	
bleibt	Verb	
finden	Verb	
suchst	Verb	
finde	Verb	
könnt	Verb	
wissen	Verb	
hoffe	Verb	
arbeiten	Verb	
hoffen	Verb	
halten	Verb	
singt	Verb	
arbeite	Verb	
arbeitest	Verb	
halte	Verb	
arbeitet	Verb	
weißt	Verb	
singe	Verb	
zahn	Noun	
hände	Noun	
drücken	Verb	
arme	Noun	
hand	Noun	
drücke	Verb	
drückt	Verb	
mund	Noun	
ohr	Noun	
nasen	Noun	
körper	Noun	
augen	Noun	
schluss	Noun	
phasen	Noun	
alter	Noun	
endet	Verb	
jahrhundert	Noun	
weihnachten	Noun	
februar	Noun	
letzte	Adjective	
dezember	Noun	
jemand	Determiner	
meditiere	Verb	
schicksal	Noun	
geist	Noun	
geister	Noun	
meditiert	Verb	
hoffnung	Noun	
meditieren	Verb	
glücklich	Adjective	
wunderschön	Adjective	
gefühlen	Noun	
gefühl	Noun	
gefühle	Noun	
leben	Noun	
sinn	Noun	
seele	Noun	
seelen	Noun	
wunder	Noun	
spiritualität	Noun	
termine	Noun	
momente	Noun	
moment	Noun	
termin	Noun	
wolle	Noun	
beton	Noun	
kalender	Noun	
jahreszeiten	Noun	
daten	Noun	
oktober	Noun	
öffnet	Verb	
treppen	Noun	
decke	Noun	
jahr	Noun	
jahre	Noun	
frühling	Noun	
märz	Noun	
spargel	Noun	
schmetterlinge	Noun	
gänse	Noun	
fuchs	Noun	
beißen	Verb	
eule	Noun	
schafe	Noun	
eichhörnchen	Noun	
gans	Noun	
schmetterling	Noun	
eulen	Noun	
zeitmaschine	Noun	
magische	Adjective	
einhorn	Noun	
verschwinde	Verb	
magischen	Adjective	
verschwinden	Verb	
unglaublich	Adjective	
nichts	Determiner	
weltraum	Noun	
entdeckt	Verb	
galaxie	Noun	
dimension	Noun	
außerirdischen	Noun	
außerirdische	Noun	
raumschiff	Noun	
planeten	Noun	
retten	Verb	
drachen	Noun	
hexe	Noun	
rettet	Verb	
drache	Noun	
magisch	Adjective	
magie	Noun	
sänger	Noun	
opern	Noun	
sängerin	Noun	
klingt	Verb	
oper	Noun	
dirigent	Noun	
trommel	Noun	
dirigenten	Noun	
orchester	Noun	
dirigiert	Verb	
melodie	Noun	
flöte	Noun	
komponist	Noun	
klavier	Noun	
deren		
dessen		
öl	Noun	
salz	Noun	
reis	Noun	
nudeln	Noun	
zucker	Noun	
schokolade	Noun	
erdbeere	Noun	
ei	Noun	
fleisch	Noun	
käse	Noun	
gemüse	Noun	
kartoffel	Noun	
denen		
billiger	Adjective	
protestieren	Verb	
protestiert	Verb	
verband	Noun	
rat	Noun	
anspruch	Noun	
korrupt	Adjective	
amt	Noun	
steuern	Noun	
polizei	Noun	
steuer	Noun	
veranstaltungen	Noun	
veranstaltung	Noun	
bundesrepublik	Noun	
freiheit	Noun	
strategie	Noun	
nordpol	Noun	
russland	Proper noun	
türkei	Proper noun	
polen	Proper noun	
südpol	Noun	
pyramide	Noun	
pyramiden	Noun	
südamerika	Proper noun	
nordamerika	Proper noun	
asien	Proper noun	
europäische	Adjective	
kontinent	Noun	
china	Proper noun	
indien	Proper noun	
europäisch	Adjective	
australien	Proper noun	
orangensaft	Noun	
apfelsaft	Noun	
orange	Noun	
saft	Noun	
bier	Noun	
wein	Noun	
kaffee	Noun	
tee	Noun	
fisch	Noun	
pizzas	Noun	
pizza	Noun	
suppe	Noun	
bücher	Noun	
besten	Adjective	
beste	Adjective	
bessere	Adjective

gewöhnlich	Adjective	

guter	Adjective	
gutes	Adjective	
gutem	Adjective	
guten	Adjective	
gute	Adjective	
super	Adjective	
viele	Determiner	
anderes	Determiner	
anderen	Determiner	
jede	Determiner	
jedes	Determiner	
andere	Determiner	
diesen	Pronoun	
ihren	Pronoun	
euren	Pronoun	
unseren	Pronoun	
diese	Pronoun	
sein	Pronoun	
euer	Pronoun	
deinen	Pronoun	
eure	Pronoun	
ihre	Pronoun	
seinen	Pronoun	
größere	Adjective	
schnelles	Adjective	
schnecke	Noun	
schnellen	Adjective	
berlin	Proper noun	
kiosk	Noun	
feiere	Verb	
feiert	Verb	
tag der deutschen einheit		
entschuldigung	Noun	
feste	Noun	
brezel	Noun	
brezeln	Noun	
pils	Noun	
oktoberfest	Noun	
wurst	Noun	
würste	Noun	
sauerkraut	Noun	
irgendwer	Determiner	
irgendwas	Determiner
	
werkzeuge	Noun	
werkzeug	Noun	
flugzeuge	Noun	

fernseher	Noun	
medien	Noun	
laden	Verb	
netze	Noun	
internet	Noun	
fuhren	Verb	
schliefen	Verb	
schlief	Verb	
festplatte	Noun	
zeitschrift	Noun	
presse	Noun	
kabel	Noun	
nachrichten	Noun	
startest	Verb	
nachricht	Noun	
interviews	Noun	
dialoge	Noun	
telefon	Noun	
gespräch	Noun	
ruft	Verb	
handy	Noun	
kommunikation	Noun	
monitor	Noun	
informationen	Noun	
rufen	Verb	
computer	Noun	

zubehör	Noun	
böden	Noun	
dachte	Verb	
dachten	Verb	
gab	Verb	
lasen	Verb	
sahen	Verb	
kamen	Verb	
tranken	Verb	
begannst	Verb	
war	Verb	
sah	Verb	
ging	Verb	
trank	Verb	
waren	Verb	
ägypten	Proper noun	
anregung	Noun	
anregungen	Noun	
fehler	Noun	
funktionen	Noun	
funktion	Noun	
band	Noun	
mitte	Noun	
teil	Noun	
nutzung	Noun	
grundlagen	Noun	
eintrag	Noun	
aufnahmen	Noun	
aufnahme	Noun	
alternative	Noun	
detail	Noun	
grundlage	Noun	
details	Noun	
arten	Noun	
art	Noun	
anforderungen	Noun	
breite	Noun	
wechsel	Noun	
anforderung	Noun	
ansicht	Noun	
aufgabe	Noun	
tiefe	Noun	
aufgaben	Noun	
ansichten	Noun	
standards	Noun	
möglichkeit	Noun	
schritt	Noun	
schritte	Noun	
möglichkeiten	Noun	
schutz	Noun	
folge	Noun	
verantwortung	Noun	
risiken	Noun	
ebene	Noun	
bezeichnung	Noun	
reihe	Noun	
struktur	Noun	
punkte	Noun	
risiko	Noun	
ausdruck	Noun	
strukturen	Noun	
punkt	Noun	
einheit	Noun	
angaben	Noun	
ausnahmen	Noun	
ausnahme	Noun	
entfernung	Noun

sicht	Noun	
quellen	Noun	
quelle	Noun	
zusammenhang	Noun	
übersicht	Noun	
leitung	Noun	
leitungen	Noun	
situation	Noun	
format	Noun	
vorteile	Noun	
gegensatz	Noun	
wertung	Noun	
vorteil	Noun	
fassung	Noun	
betreuung	Noun	
vorbereitung	Noun	
lauf	Noun	
laufe	Noun	
ton	Noun	
serie	Noun	
ordnung	Noun	
zweck	Noun	
abteilungen	Noun	
austausch	Noun	
merkmale	Noun	
berechnung	Noun	
sitz	Noun	
figuren	Noun	
option	Noun	
figur	Noun	
optionen	Noun	
herkunft	Noun	
prinzip	Noun	
zeitreise	Noun	
bearbeitest	Verb	
berechtigen	Verb	
behandelt	Verb	
bestätige	Verb	
beraten	Verb	
besteht	Verb	
hängt	Verb	
leistet	Verb	
vergebe	Verb	
genügt	Verb	
vermitteln	Verb	
soll	Verb	
lassen	Verb	
erfährt	Verb	
garantieren	Verb	
installiert	Verb	
vertritt	Verb	
aktivieren	Verb	
handelt	Verb	
ergibt	Verb	
behalten	Verb	
benötige	Verb	
entfernen	Verb	
eröffnen	Verb	
diskutieren	Verb	
schützen	Verb	
verlässt	Verb	
erklärt	Verb	
setzen	Verb	
lösen	Verb	
verfügen	Verb	
beachten	Verb	
empfehlen	Verb	
versuchen	Verb	
wirkst	Verb	
schafft	Verb	
fordern	Verb	
führt	Verb	
existiert	Verb	
kooperation	Noun	
karte	Noun	
symbol	Noun	
schau	Noun	
vermittlung	Noun	
abschluss	Noun	
runde	Noun	
ansatz	Noun	
umgang	Noun	
einstellung	Noun	
eingang	Noun	
empfang	Noun	
vortrag	Noun	
bezug	Noun	
charaktere	Noun	
gefahr	Noun	
material	Noun	
gewalt	Noun	
qualifikation	Noun	
charakter	Noun	
oberfläche	Noun	
verpflichtungen	Noun	
niveau	Noun	
vorstellung	Noun	
tradition	Noun	
agentur	Noun	
umfang	Noun	
auflage	Noun	
versorgung	Noun	
reparatur	Noun	
anteil	Noun	
rest	Noun	
geschwindigkeit	Noun	
ereignisse	Noun	
eröffnung	Noun	
beispiel	Noun	
abschnitt	Noun	
durchschnitt	Noun	
eintritt	Noun	
verlust	Noun	
inhalten	Noun	
anlage	Noun	
system	Noun	
rubrik	Noun	
anlagen	Noun	
vergleich	Noun	
kriterien	Noun	
anwendungen	Noun	
förderung	Noun	
seien	Verb	
sei	Verb
entscheidungen	Noun	
kontrolle	Noun	
verfahren	Noun	
bedingungen	Noun	
schaden	Noun	
prozesse	Noun	
prozess	Noun	
vorschriften	Noun	
rathaus	Noun	
regel	Noun	
wählen	Verb	
einfluss	Noun	
prinzessin	Noun	
recht	Noun	
kampf	Noun	
regierungen	Noun	
genehmigung	Noun	
krieg	Noun	
regierung	Noun	
ministerium	Noun	
wahl	Noun	
staat	Noun	
verwaltung	Noun	
behörden	Noun	
gesetze	Noun	
politikerin	Noun	
republik	Noun	
vertrag	Noun	
interesse	Noun	
volk	Noun	
erfolg	Noun	
stimmen	Noun	
frieden	Noun	
parteien	Noun	
präsident	Noun	
partei	Noun	
politik	Noun	
stimme	Noun	
macht	Noun	
tempel	Noun	
mönche	Noun	
wiedergeburt	Noun	
juden	Noun	
buddhismus	Noun	
christ	Noun	
muslim	Noun	
heilige	Adjective	
islam	Noun	
betet	Verb	
götter	Noun	
priester	Noun	
gott	Noun	
dokumentation	Noun	
tätigkeiten	Noun	
kamera	Noun	
schauspieler	Noun	
plastik	Noun	
kino	Noun	
mode	Noun	
tanz	Noun	
rahmen	Noun	
konzert	Noun	
stil	Noun	
bühne	Noun	
sammlung	Noun	
lied	Noun	
literatur	Noun	
fotografie	Noun	
kritik	Noun	
museum	Noun	
design	Noun	
lieder	Noun	
modelle	Noun	
tanzt	Verb	
film	Noun	
regie	Noun	
tanze	Verb	
filme	Noun	
tanzen	Verb	
entwurf	Noun	
start	Noun	
modell	Noun	
instrumente	Noun	
künstler	Noun	
theater	Noun	
kultur	Noun	
musik	Noun	
musiker	Noun	
galerie	Noun	
ausstellungen	Noun	
ausstellung	Noun	
kunst	Noun	
studio	Noun	
bewegungen	Noun	
wette	Noun	
schwimmbad	Noun	
ski	Noun	
freizeit	Noun	
sieg	Noun	
teilnahme	Noun	
spieler	Noun	
bundesliga	Proper noun	
spiel	Noun	
zuschauer	Noun	
liga	Noun	
spiele	Noun	
team	Noun	
sport	Noun	
hobby	Noun	
aktivitäten	Noun	
ball	Noun	
fußball	Noun

	
dienstleistungen	Noun	
einzelhandel	Noun	
bedarf	Noun	
logistik	Noun	
branchen	Noun	
verhandelt	Verb	
betrieb	Noun	
ausgaben	Noun	
gründung	Noun	
börse	Noun	
kundenservice	Noun	
leistungen	Noun	
stellenangebote	Noun	
produktion	Noun	
marke	Noun	
service	Noun	
bewertung	Noun	
werbung	Noun	
lager	Noun	
bezahlung	Noun	
antrag	Noun	
chancen	Noun	
angebot	Noun	
auftrag	Noun	
garantie	Noun	
anzeige	Noun	
versicherung	Noun	
tabelle	Noun	
lieferung	Noun	
verkauf	Noun	
ware	Noun	
firma	Noun	
industrie	Noun	
kombination	Noun	
überblick	Noun	
zustand	Noun	
umsetzung	Noun	
blick	Noun	
einsatz	Noun	
party	Noun	
einzelheiten	Noun	
felder	Noun	
gewicht	Noun	
referenzen	Noun	
wirkung	Noun	
stufe	Noun	
anleitung	Noun	
rolle	Noun	
verlauf	Noun	
hintergrund	Noun	
verwendung	Noun	
einführung	Noun	
spalte	Noun	
mitteln	Noun	
mittel	Noun	
position	Noun	
vorschläge	Noun	
zugang	Noun	
höhe	Noun	
länge	Noun	
kraft	Noun	
eigenschaften	Noun	
kategorie	Noun	
unterstützung	Noun	
menge	Noun	
liste	Noun	
verbesserung	Noun	
erfahrung	Noun	
unterschiede	Noun	
versionen	Noun	
planung	Noun	
basis	Noun
	
hätten	Verb	
wären	Verb	
könnten	Verb	
würde	Verb	
muskel	Noun	
organ	Noun	
oberschenkel	Noun	
leber	Noun	
muskeln	Noun	
organe	Noun	
knochen	Noun	
darm	Noun	
hüften	Noun	
ellbogen	Noun	
zehen	Noun	
hüfte	Noun	
knöchel	Noun	
ferse	Noun	
knie	Noun	
daumen	Noun	
handgelenk	Noun	
dicken	Adjective	
bauch	Noun	
brustkorb	Noun	
stirn	Noun	
lungen	Noun	
lunge	Noun	
kinn	Noun	
wespen	Noun	
streifen	Noun	
zebra	Noun	
giraffe	Noun	
säugetiere	Noun	
schaf	Noun	
beißt	Verb	
brennen	Verb	
stimmt	Verb	
wird	Verb	
möchtest	Verb	
teilen	Verb	
nutzen	Verb	
tritt	Verb	
verhindern	Verb	
verändern	Verb	
vergisst	Verb	
entwickelt	Verb	
fördern	Verb	
vermeiden	Verb	
vergleichen	Verb	
bekomme	Verb	
betrifft	Verb	
bekommt	Verb	
beantworten	Verb	
bewegt	Verb	
berechnen	Verb	
berichten	Verb	
erreichen	Verb	
erwirbt	Verb	
erhält	Verb	
erleben	Verb	
ermöglichen	Verb	
erscheinen	Verb	
erwarten	Verb	
erhöhen	Verb	
ermittelt	Verb	
unterstützen	Verb	
wenden	Verb	
dienen	Verb	
verdienen	Verb	
überprüfen	Verb	
bewerten	Verb	
achten	Verb	
wechseln	Verb	
definiert	Verb	
markiert	Verb	
zitieren	Verb	
kontaktieren	Verb	
präsentieren	Verb	
basieren	Verb	
bitten	Verb	
springt	Verb	
sichern	Verb	
redet	Verb	
meldet	Verb	
nennen	Verb	
merken	Verb	
versuch	Noun	
nähe	Noun	
qualität	Noun	
gelegenheit	Noun	
zusammenarbeit	Noun	
hilfe	Noun	
entwicklung	Noun	
ergebnisse	Noun	
sicherheit	Noun	
kompetenz	Noun	
engagement	Noun	
ding	Noun	
druck	Noun	
empfehlung	Noun	
auswahl	Noun	
lage	Noun	
gebrauch	Noun	
weise	Noun	
änderung	Noun	
problem	Noun	
ziel	Noun	
form	Noun	
lösungen	Noun	
verhalten	Noun	
hinweise	Noun	
übersetzungen	Noun	
übersetzung	Noun	
unterhaltung	Noun	
zusammenfassung	Noun	
begriffe	Noun	
bedeutet	Verb	
satz	Noun	
verzeichnis	Noun	
französisch	Noun	
kapitel	Noun	
zeichen	Noun	
erklärung	Noun	
meinung	Noun	
konzept	Noun	
berichte	Noun	
konzepte	Noun	
titel	Noun	
zustimmung	Noun	
wörter	Noun	
handbuch	Noun	
text	Noun	
geschichten	Noun	
geschichte	Noun	
idee	Noun	
sprachen	Noun	
beschreibung	Noun	
schrift	Noun	
wörterbuch	Noun	
bedeutung	Noun	
sprache	Noun	
	
chemisches	Adjective	
nachweis	Noun	
kunststoff	Noun	
analyse	Noun	
analysen	Noun	
gas	Noun	
atmosphäre	Noun	
wissenschaftlerinnen	Noun	
wissenschaftlerin	Noun	
lehrbuch	Noun	
methode	Noun	
praktikum	Noun	
biologie	Noun	
technik	Noun	
statistiken	Noun	
maschinen	Noun	
studie	Noun	
element	Noun	
statistik	Noun	
studien	Noun	
messen	Verb	
energie	Noun	
achtung	Noun	
strahlung	Noun	
temperatur	Noun	
messe	Verb	
motor	Noun	
physik	Noun	
wissenschaft	Noun	
theorie	Noun	
erfindung	Noun	
kenntnisse	Noun	
kenntnis	Noun	
definition	Noun	

akademie	Noun	
leser	Noun

herzlich	Adjective	

strom	Noun	
klima	Noun	
wüste	Noun	
pflanzen	Noun	
bach	Noun	
wald	Noun	
all	Noun	
rhein	Proper noun	
tierwelt	Noun	
wiese	Noun	
gras	Noun	
umwelt	Noun	
deiner	Pronoun	
meines	Pronoun	
seiner	Pronoun	
ihrer	Pronoun	
zahlreiche	Adjective	
wenige	Determiner	
traum	Noun	
stunde	Noun	
geburtstag	Noun	
besuche	Verb	
besucht	Verb	
paare	Noun	
besuchen	Verb	
besuchst	Verb	
alkohol	Noun	
unfall	Noun	
medikamente	Noun	
bestellen	Verb	
findet	Verb	
hauptstadt	Noun	
europa	Proper noun	
ferienhäuser	Noun	
ausland	Noun	
innere	Noun	
heimat	Noun	
ferienhaus	Noun	
insel	Noun	
umgebung	Noun	
grundstück	Noun	
fläche	Noun	
halle	Noun	
zentrum	Noun	
zentrale	Noun	
innenstadt	Noun	
hof	Noun	
pension	Noun	
kühlschränke	Noun	
karton	Noun	
schüssel	Noun	
großes	Adjective	
kleinen	Adjective	
großer	Adjective	
kleines	Adjective	
großen	Adjective	
große	Adjective	
sagen	Verb	
zeige	Verb	
sagt	Verb	
zeigt	Verb	
sage	Verb	
zeigen	Verb	
gebe	Verb	
geben	Verb	
gibt	Verb	
dieser	Pronoun	
dieses	Pronoun	
nachtisch	Noun	
abendessen	Noun	
kuchen	Noun	
löffel	Noun	
vorspeise	Noun	
knoblauch	Noun	
senf	Noun	
hauptgericht	Noun	
kocht	Verb	
kochst	Verb	
rezept	Noun	
honig	Noun	
straße	Noun	
märkte	Noun	
luft	Noun	
fallen	Verb	
läuft	Verb	
siehst	Verb	
sehe	Verb	
sehen	Verb	
denkt	Verb	
unser	Pronoun	
unsere	Pronoun	
baby	Noun	
stuhl	Noun	
ente	Noun	
blume	Noun	
berg	Noun	
obst	Noun	
apfel	Noun	
