Er ist bereits da : He is already there
Jeder Mietwagen ist genauso nützlich: Each rental car is just as useful
Die Person ist sowohl gut als auch hilfreich : The person is both good and helpful
mindestens : at least, for at least
Dazu möchte ich nichts sagen : I don't want to say anything about that
Es ist notwendig, daher ist es möglich : It is necessary, therefore it is possible
Sonst hat sie nichts : Other than that she has nothing
Die Freunde sind durchaus echt : The friends are absolutely real
Die Frage hat jedoch keine Antwort : The question however does not have an answer
Viele Menchen leben allein : Many people live by themselves
Ich werde mich nochmals melden : I will contact you again
Das Publikum ist dennoch zufrieden : The audience is pleased nevertheless
Ich spreche nur Englisch : I speak only English
Ja, das ist ziemlich lecker : Yes, that is pretty delicious
Derzeit sind viele Frauen an der Universität : Currently there are many women at the university
Keine Frau ist so natürlich schön wie du : No woman is as naturally beautiful as you
Das ist gar nicht witzig : That is not funny at all
Wir lesen das Ende immer zuerst : we always read the end first
Mal schauen was wir noch haben : Let's see what we still have
Damals, im Juli : Back then, in July
Ich gehe jetzt rein : I am going inside now
Man Zählt von links nach rechts und von vorne nach hinten : One counts from left to right and from front to back
Deutschland wird Bildung weiterhin fördern : Germany will continue to promote education
Ich werde hierzu nichts sagen : I will not say anything about this
Er ist Bauer und Lehrer zugleich : He is a farmer and a teacher at the same time
Meine Damen und Herren, Kommen Site bitte hierher : Ladies and gentlemen, come this way please
Jemand ist dir voraus : Someone is ahead of you
Ich bin unterwegs nach Berlin : I am on the road to Berlin
Vorher müssen wir was kochen : We have to cook something beforehand
Ansonten haben die Gebäude alles : Apart from that the buildings have everything
Diese Katze ist irgendwiese seltsam : This cat is somehow strange
Lieferung an wen? : Shipment to whom?
Freizeit ist Kindern wichtig : Freetime is important to children
Wir hatten noch nie so viele zuschauer : we never had these many spectators
Die Mannschaft ist toll : the team is terrific
Das Restaurant ist beliebt : The restaurant is popular
Alles is relativ : Everything is relative
Ich mache doch nichts kaputt : I am not breaking anything
Das ist allgemein richtig : That is generally right
Die Butter schmeckt komisch : The butter tastes strange
Sein Schlaf ist fest : His sleep is sound
Der Teller is auch kaputt : The plate is broken too
Ihr Gegner ist extrem : Her opponent is extreme
Das Leder ist fest : The leather is firm
Ja tatsächlich : Yes, really
Ich habe nichts mit him gemeinsam : I have nothing in common with him
Es ist egal wer du bist : It does not matter who you are 
Bäume sind nützlich : Trees are valuable
Haut ist sichtbar : Skin is visible
Luft ist notwendig : Air is necessary
Beziehungen sind praktisch : Relationships are practical
We sprachen deutlich : We speak clearly
Mathematik ist praktisch im Alltag : Mathematics is practical in everyday life
Was ist möglich : What is possible
Bleib positiv : stay positive
Sie ist unabhängig : She is independent
Hat es nicht funktioniert? : Had it not worked out?
Es war eine Fernbeziehung ? : It was a long-distance relationship
Paare leben weit voneinander entfernt  : Couples live far apart
Ist alles okay ? : Is everything okay?
Klar! Erzähl mir von deinem neuen Freund : Sure, tell me about your new friend
Na ja, das Beste ist, dass er witzig ist! : Well, the best is that he is funny
Ein ziemlich seltener Name : A quite rare name 
nicht häufig : not often
Ich habe heute keinen Unterricht mehr : I do not have classes anymore
Wie heißt er? : What is his name?
Er ist ein sehr netter Mann: He is a very nice man
Du kannst mit dem Raten aufhören : You can stop guessing
Ich sterbe hier vor Neugier : I die here of curiosity
Ich will es unbedingt wissen : I want to know that absolutely
Klingt nett : Sounds good
Ich weiß viele dinge : I know many things
Zum Beispiel, dass deine Lieblingsfarbe blau ist : For example your favourite colour is blue
Wie auch immer : Anyway
Es sieht so aus : It looks like that
Es war schön, dich zu sehen :  It was nice to see you
der eigenartigen Begegnung : The strange encounter
Sie saß direkt neben mir! : She was sitting right next to me!
Das klingt ernst : That sounds serious
ich war nicht ehrlich zu dir: I was not honest with you
Ich habe dich angelogen : I lied to you
Ich muss dir einfach die Wahrheit sagen : I just have to tell you the truth
Wovon sprichst du? : What are you talking about?
Na, da bin ich erleichtert : Well I am relieved
Folge den Pfeilen : follow the arrows
was ist los? : What is happening?
Die Pfeile leuchten im Dunkeln : The arrows shine in the dark
Ich bin neugierig : I am curious
Ich will herausfinden, was hier los ist : I want to find out what is going on here
Sei bitte vorsichtig! : Please be careful!
überraschung : Surprise
Alles Gute zum Geburtstag : Happy Birthday 
Jetzt lasst uns feiern! : Now let's party
Bist du wach? : Are you awake
kannst du mir einen Gefallen tun : Can you do me a favor
Ich habe bisher nie einen gebraucht : I have never needed one before
Leg nicht auf! : Do not hang up
Ich schulde dir einen riesigen Gefallen : I owe you a huge favor
Abflugbereit : Ready for departure
Was ist so ungewöhnlich daran : What is so unusal about it
Da denkst du bestimmt an jemand anderen : You're probably thinking of someone else.
Er macht eine Ansage : He makes an announcement
Das wäre albern : That would be silly
Was ist zuerst passiert? : What happend first?
Das bildest du dir alles ein : That's what you imagine
Mach zwei daraus : Make that two
von vorn beginnen : start over
Das klingt gut : That sounds good
Meine Tochter will ein Klavier : My daughter wants a piano
The orchestra was conducted by the conductor : Das Orchester wurde vom Dirigenten dirigiert
Der Komponist schreibt Lieder : The composer is writing songs
Freiheit ist wichtig : Freedom is important
Achtung, the polizei : Attention, the police
Europas Wirtschaft läuft schon besser : Europe's economy is doing better already.
Besuche sind nur nach Vereinbarung möglich : Visits are only possible by appointment.
Freiheit steht unter dem Schutz des Königs : Freedom is under the protection of the king
Das Alien hat ein weißes Weltraumschiff : The alien has a white space ship.
Wir hatten die Lösung entdeckt. : We had discovered the solution.
Das ist unglaublich! : That's incredible
Wenn du eine Zeitreise machen könntest, was würdest du dir anschauen? : If you could go on a time travel, what would you look at?
Sie hätten das Haus entdeckt : They would have discovered the house.
Es war eine magische Nachtc : It was a magical night
Augen sind die Fenster der Seele : Eyes are the windows to the soul
Das Gefühl : The feeling
Everything has a reason : Alles hat seinen Sinn
Es gibt noch Hoffnung : There is still hope
Ich sage den Opfern die Wahrheit : I tell the truth to the victims
Die Philosophie passt zu dir : Die Philosophie passt zu dir
Er lag auf ihrem Balkon : He was lying on her balcony
Die Straße führte nach Osten : The road led east 
Ließ ich sie zu oft allein? : Did I leave them alone too often?
Der Wind ließ nach : The wind died down
Gewalt ist eine Gefahr : Violence is a threat.
Die Förderung ist wichtig : The promotion is important
Der Eintritt ist frei : Admission is free.
Er spricht über Ereignisse in seinem Leben : He talks about events in his life
Großvater und ich werden für den Baum sorgen : Grandfather and I will worry for the tree
Großvater und ich werden dafür sorgen, dass alles rund läuft : Grandfather and I will ensure that everything runs smoothly
Wir werden die Fotos ansehen : We will look at the photos 
Ich werde jetzt übernehmen : I will take over now
Er wird einen von euch auswählen : He will choose one of you
Ich werde es wieder entferen : I will remove it again
Er wird mehr leisten : He will accomplish more
Er wird für den Großvater anfragen : He will ask on behalf of the grandpfather
Das wird nicht reichen : That will not be enough
Er wird seine Kompetenz erhöhen : He will increase his competence
Ich werde beide vergleichen : I will compare both
Kannst du morgen den Brief abgeben : Can you hand in the letter tomorrow
I will hike up there : Ich werder da hoch wandern
Er wird uns den Namen des Herstellers nennen : He will tell us the name of the manufacturer
Ich werde dir mehr zahlen : I will pay you more
Leben ist der Zweck : Life is the purpose
Das Prinzip : The principle
Der Rektor : The principal
Der Fehler : The mistake
Der Wechsel : The change
Wie viele Fotos soll ich machen ?: How many photos should I take?
Die organization hat verschiedene Abteilungen : The organization has different departments
Ich bin verantwortlich für ihren Schutz : I am responsible for her protection
sei vorsichtig : be careful
Would he love Germany? : Würde er Deutschland lieben
Würde er die Sterne sammeln? :  Would he collect the stars?
Ich würde es verdienen : I would earn it
Er würde den Kontakt abbrechen : He would break contact
Würden Sie auf mich warten? : Would you wait for me?
Du würdest viel Schmuck besitzen : You would own a lot of jewellery
Leute sind verschwunden : People have disappeared
Du hast meine Hand gehalten : You have held my hand
Sie hat mir eine Tasse Tee gebracht : She brought me a cup of tea
He has founded three companies already : Er hat schon drie Firmen gegründet
Ich habe keine Nummer gewählt : I have not dialed any number
Daran habe ich nicht gedacht : I didn't think about it
Er hat es nicht geschafft : He did not accomplish it
Ich weiß nicht genau, wie es passiert ist :  I do not exactly know how it happened.
Habt ihr ihn geprüft? : Did you test him?
Er hat einen Verein gegründet : He founded an association
Er hat das gewusst : He knew that
Die Milch ist schlecht geworden : The milk has become bad
Ich habe das nicht bestellt : I did not order this
Sie sind zu früh gekommen : You came too early
Wir sind bereits gelaufen : We have already walked 
Ich bin noch nie im Ausland gewesen : I have never been abroad
Es hat mir nicht gefallen : I did not like it 
Ich bin in Kanada gewesen : I have been to Cananda
Eulen die sprechen beißen nicht : Owls that talk don't bite 
Leute, die Tiere hassen, mag ich nicht : I don't like people who hate animals
Sie wohnt in einem Haus, dessen Dach schwarz ist : She lives in a house whose roof is black
Er ist jemand, dem ich glaube : He is someone I believe
Das ist die Fähre, die wir jeden Abend sehen. : That is the ferry that we see every evening
Das sind Lieder die wir lieben : These are songs that we love
Die Stadt, in der ich wohne, ist groß : The city I live in is big 
Du wirst den Regenschirm vor vier Uhr gekauft haben : You will have purchased the umbrella before four o'clock
Will you have given the mayor the message? : Wirst du die Nachricht dem Bürgermeister gesagt haben?
Dieser Bahnof wird ab morgen geschlossen sein  : This train station will be closed after tomorrow
Morgen wird die Familie gefahren sein : Tomorrow the family will have driven
You will have left : Du wirst gegangen sein
Die Tür wird geschlossen sein : The door will be closed
Im Dezember werdet ihr das Produkt gekauft haben : You will have bought the product in December
Wann werden sie gegangen sein? : When will they have gone?
Wirst du mir bis zum Wochenende den Plan gesagt haben? : Wirst du mir bis zum Wochenende den Plan gesagt haben?
Wir könnten in das Restaurant gehen : We could go into the restaurant
Das wäre gut : That would be good
Sie würde im Restaurant anfragen, wenn du essen willst : She would inquire in the restaurant, if you want to eat
Sie würde wegen den Schafen die Universität wechseln : She would change her university because of the sheep.
Warum würden Sie das Essen verhindern? : Why would you prevent the meal?
Es ist als würde ich mit mir selbst reden : It is as if I were speaking to myself.
Die Medizin würde morgen wirken : The medicine would take effect tomorrow
Ich sagte ich würde dich unterstützen : I said I would support you
Wer würde es verhindern? : Who would prevent it?
Ich würde Sie sofort einstellen : I would hire you immediately
Jeder Cent würde zählen : Every cent would count
Er könnte es machen : He could do it 
Könntest du die Frage wiederholen? : Could you repeat the question
Ich hätte ihr Buch nicht veröffentlicht : I ould not have published her book
Wir wären für immer Freunde gewesen : We would have been friends forever
Ich hätte nein gesagt : I would have said no
Wir hätten es von ihr erfahren : We would have found it out from her
Sie hätten noch keine Aktien vergeben : They would not have given out shares yet
Das hätten sie mir gesagt : They would have told me that
Ohne die Zeitung hätten wir es nie erfahren : Without the newspaper we never would have found out about it.
Das wäre gut gewesen : That would have been good
Wir dachten, du hättest uns verlassen : We thought you had left us
Ich wäre nie auf die Idee gekommen : I would never have thought of that
Sie wären für ihn gut gewesen : They would have been good for him
Drücken wir den hinweis : Let's print the note
Geld is wertvoll : Gold is valuable
Sicherheit ist haüfig teuer : Safety is often costly
Information und Verhalten : Information and behavior
The Lage : the position
die Auswahl : the selection
die ergebnisse sind da : the results are there
Der höchste Berg von Africa : The highest mountain of Africa
Sind das günstige Hotels? : Are these cheap hotels
Der ehemalige Bahnhof ist jetzt ein Restaurant : The former train station is a restaurant now.
Ja, mir geht es gut : Yes I am fine 
Wie geht es ihm : How is him 
Was gibst du diesem Hund? : What do you give this dog?
Ist dir schlecht ? : Are you sick
Wie geht es deiner Frau : How is your wife doing?
Er bringst es mir : He is bringing it to me
Warum hilfst du ihrem Mann : Why are you helping her husband
Meinen Freunden geht es gut : My friends are doing fine
Ich zeige dieser Frau den Garten : I show the garden to this woman
Hans ist der Bruder von Karl : Hans is Karl's brother
Trinkst du beim Essen : Do you drink while eating
In dem gesamten Haus gibt es drei Fenster  : The entire house has three windows.
Was passiert mit den privaten Daten?  : What happens to the personal data?
Sie schenkt ihm ein Schwein : She gives him a pig
Er ersetzt alles mit persönlichen Namen : He replaces everything with personal names.
Sprichst du mit der bekannten Ärztin : Are you talking to that famous doctor?
Was passiert an einem normalen Tag? :  What happens on a normal day?
Sie ist jetzt in ihrer eigenen Welt:  She is in her own world now
Er spricht von den vergangenen Tagen : He is talking about the past days
Hunde schwimmen sehr gern : Dogs really like to swim 
Das Haus ist eher klein : The house is rather small
Die Hochzeit ist super : The wedding is excellent
Das ist nicht ganz richtig : That is not entirely correct
Guten Flug! : Have a good flight
Sei nicht traurig : Don't be sad 
Geht ohne mich : Go without me
Lass das! : Leave it
Ruf sie : Call her
Geht alleine! : Go alone 
Handelt langsam! : Act slowly
Bleib bei mir : Stay with me 
Der gesamte Betrag : the entire amount
Wer ist für die Zahlung verantwortlich? : Who is responsible for the payment?
Die Rechnung ist richtig : The bill is correct 
Für sehr hohe Zinsen natürlich : For very high interest ofcourse
Es gibt keine Frist : There is no deadline
Wann hatte sie ihn verlassen : When had she left him?
Sie hatten vor dem Frühstück die Schüler geprüft : They had tested the students before the breakfast
Nachdem ich Deutschland verlassen hatte, war ich traurig :  After I had left Germany, I was sad
Sie hatten das Spielzeug noch nicht geprüft : They had not tested the toy yet
Ich hatte seit Tagen nichts mehr gegessen : I had not eaten in days
Wie hatte sie davon erfahren : How had she found out about it?
Ihr hattet  die gute Nachricht für euch behalten : You had kept the good news to yourselves
Ich hatte durch die Zeitung davon erfahren : I had found out about it from the newspaper
Nachdem sie mich verlassen hatte, konnte ich nicht mehr schlafen : After she had left me, I could not sleep anymore.
Was bin ich ohne dich? : What am I without you
Der Mann fährt die Straße entlang : The man is driving along the street 
Ich kenne ihn durch einen Freund : I know him through a friend
Was ist das für ein Zeug? : What is this stuff?
Irgendwann reicht es : At some point it is enough
Sie sagt irgendwas : She says something
Ich bin irgendwie traurig : Somehow I am sad
Kennt irgendwer ein Rezept : Does anyone know a recipe
Ich bin irgendwie traurig : Somehow I am sad
Pass auf dich auf : Take care of yourself
Wegen ihm beginnen wir : Because of him, we are beginning.
Der Vögel sitzt  auf dem Tisch : The birds are sitting on the table
Wann kommen wir an? : When do we arrive 
Das Öl ist im Laden : The oil is in the store.
Wir essen, während wir laufen : We eat as we walk
Zwölf geteilt durch vier gleich drei : Twelve divided by four equals three





noch mal : once again
Du kannst mir Unterlagen für das Meeting im Hotel hinterlegen : You can deposit documents for the meeting in the hotel
Alle Richtungen : All directions 
Gute reise : Have a nice trip
danke schön : Thank you very much
Die Tasche ist weg : The bag is gone
Wohin willst du : where do you want to go
Die kenne ich nicht : I  do not know her
Komm wir helfen dir : come on we help you
Mein Name ist Emma : My name is Emma
Meine mama fliegt nach Amerika Sie arbeitet da : My mum flies to America She works there
Ich heiß Nico, und wie heißt du? : My name is Nico and what is your name?
Ich muss noch kurz tanken : I have to fill up shortly
Sag mal, spinnst du? :  Are you crazy?
wie geht es dir : How are you
Woher kommst du genau : Where are you from exactly
Mein Vater ist Polizist : My father is a police officer
Die Frau hat ein Fahrradgeschäft : The woman has a bicycle shop
Gerne : With pleasure
mach's gut : take care
eine einladung zum Geburtstag von Charlotte :  a birthday invitation from Charlotte
herzlichen glückwunsch zum geburtstag : Happy Birthday
Im Fundbüro : In the lost property
wie ist das passiert? : How did this happen?
was machst du hier : What are you doing here
Prost : cheers
ihre bestellung : Your order
das stimmt so : that's right
ich zahle bar : I pay cash
Eine Abschiedsparty : A farewell party
fängt mich doch : Catch me
nimmst du mich mit : Are you taking with me
ein flüchtling ; a refugee
Ich spreche Deutsch, und ein bisschen Englisch : I speak German, and a little English
du bist dran : it's your turn
freut mich : I am glad
das glaube ich nicht : I do not believe that
bis gleich : see you soon
übrigens : by the way
übermorgen : day after tomorrow
Zu spät? : too late?
Ich habe gleich ein Bewerbungsgespräch : I have a job interview right now
viel erfolg : I wish you success
du findest bestimmt auch noch 'ne gute arbeit : you'll probably find a good job too
kunden beraten : to advise customers
Wo ist der Aufzug? : where is the elevator
traumberuf : Dream job
das Geschirr Spülen : do the dishes
abwaschen, abtrocknen, kochen, staubsaugen, waschen, putzen: wash, dry, boil, vacuum, wash, clean
Was macht dir Spaß? : What do you enjoy?
sehr günstig : attractively priced
Sonst noch etwas? : Anything else
Gute Besserung! :  Get Well





 