und : and
denn : because
sondern : but (as in but rather, instead) aber but
oder : or
beziehungsweise	: or, or more precisely
doch : but, however
jedoch : but, however
allein (rare expression) : 	but unfortunately


entweder ... oder : 	either ... or
sowohl ... als auch : 	both ... and
weder ... noch :	neither ... nor
einerseits, ... andererseits :	on the one hand ... on the other hand
mal ... mal : 	sometimes ... sometimes
teils ... teils : partly ... partly


bevor :	before
nachdem	: after
ehe	: before
seit, seitdem :	since (indicating time, not a causality)
w√§hrend : while, during, whereas
als	: when (in describing past events)
wenn :	when (describing present and future), if, whenever
wann :	when (for questions only)
bis :	until, by
obwohl : 	although
als ob, als wenn, als :	as if
sooft :	as often as (whenever)
sobald :	as soon as
solange :	as long as
da :	because
weil :	because
indem :	by ... -ing
ob :	whether*, if (*only use when you could say whether in English as well)
falls :	in case, if
wenn :	if, when
um ... zu	 : in order to
dass :	that
sodass :	so that
damit :	so that