Schönen Dank : Many thanks
Besten Dank : Best of thanks
Haben Sie vielen Dank! : Many thanks
Ich bin Ihnen sehr dankbar : I'm very grateful to you
Ich danke Ihnen : I thank you
Herzlichen Dank : Heartfelt thanks
Ein herzliches Dankeschön : My(Our) heartfelt thanks
Danke vielmals : Many thanks, Ich danke Ihnen vielmals
Vielen Dank : Many thanks
Danke: Thanks (informal)
Danke vielmals : Many thanks (informal)
Tausend Dank : Thanks a million
Bitteschön : You are welcome (formal)
Bitte sehr! :  Here you go! (formal)
Gern geschehen :  It was my pleasure (formal)
Mit Vergnügen : With pleasure (formal)
Bitte : welcome (informal)
Gern : It was my pleasure (informal)
Nichts zu danken : Don't mention it(informal)
Schon gut : That's fine. No problem (informal)
Kein Problem : No problem (informal)
Wie Bitte :  Pardon me
Kannst du mir bitte helfen? :  Can you help me please?
vielleicht : may be
Sprechen Sie Deutsch? : Do you speak German?
Noch einmal, bitte : Once again, please 
Wie bitte? : What did you say?
Langsamer, bitte : Slowly, please
Bitte Wiederholen Sie : please repeat that
Ich verstehe nicht : I don't understand
Ich habe eine Frage : I have a question
Wie sagt man  : How do you say..
Ich weiß nicht : I don't know
Doch! : On the contrary!
Schon gut : Okay
Mit Frühstück?:Is breakfast included?


