examining one's own thoughts and feelings - introspection
one who loves mankind - philanthropist
medicine used against a poison or a disease - antidote
to make great efforts, to struggle - strive
able to use the left hand or the right equally well - ambidextrous
Looking back on past - retrospective
a person or thing that precedes, as in a process or job. - precursors
one who turns towards himself - introvert
government ruled by old people - gerontocracy
doubtful, uncertain - ambiguous
boastful - braggart
make worse, irritate - aggravate
attract, lure - entice
make (pain) easier to bear - alleviate
add beauty, decorate - adorn
state of being balanced - equilibrium
to hate, to detest - abhor
Suggest or imply in addition to the precise, literal meaning - connote
to make an effort, to try very hard - endeavor
active, quick-moving - agile
restore something to better condition - renovate
course of study - curriculum
malicious, evil, having or showing ill will - malevolent
mix, combine, unite societies - amalgamate
a person who is attracted to foreign peoples cultures - xenophile (zen-uh-fahyl)
feeling sleepy half asleep - drowsiness
wander lose one's way - stray
undress - disrobe
Keen, quick, accurate insight or judgment - acumen
cause or have difficulty in breathing - suffocate
happening from time to time - sporadic
smell (especially pleasant) - scent
succession connected line of - sequence
Bold - audacious
close connection, relationship - affinity
strong dislike - animosity
made up of different kinds - heterogeneous
easily injured broken or destroyed - fragile
Bequest or inheritance - legacy
cruel killing of a large number of people - massacre
make quiet or calm - appease
put under water liquid sink out of sight - submerge
making unpure, poorer in quality - adulteration
process of burning - combustion
doing or happening something before the right time - premature
avoided, kept away from - shunned
severe suffering - anguish
well-suited, quick-witted - apt
hide keep secret - conceal
to complain - grumble
native - indigenous
Without preparation or forethought - offhand
rest to sit or stand in a lazy way hang (dog's tongue) - loll
have a mutual relation - correlate
rolling backward or forward (not sideways) movement - somersault
to go away suddenly (to avoid arrest) - abscond
fit to be eaten/not poisonous - edible
end the existence of/wipe or put out - extinguish
Legal or judicial inquiry, especially before a jury and especially made by a coroner into the cause of someone.s death - inquest
additional load/charge - surcharge
praise, approval - accolade
to join together - conjoin
shy easily frightened - timid
dullness/not allowing light to pass through - opaqueness
refuse to allow or accept as a correct - disallow
be faithful, to endure - abide
that cannot be permeated - impermeable
give comfort or sympathy to - console
authority written order guarantee - warrant
welcomed with shouts and approval - acclaimed
no longer active - extinct
suggest something in the past - reminiscent
substance that causes speeding up - catalyst
use in a wrong way for one's own benefit - embezzle
little depth, not earnest - shallow
customers - clientele
easily broken - brittle
taking too little care - negligent
polite and friendly - affable
the saving of property from loss - salvage
in a dying state, near death - moribund
fall back again - relapse
hand or swing loosely - dangle
go or come up - ascend
the mark * (e.g.. omitted letters) - asterisk
tale story fibers for knitting - yarn
proud, superior manner of behaviour - arrogance
getting farther apart from a point - divergence
duty support loyalty - allegiance
strong energetic - vigorous
person much smaller the usual size - dwarf
Furiously angry, enraged - livid
becoming young in nature or appearance - rejuvenation
sweet-smelling - fragrant
sound in judgment, wise - judicious
liking to give hospitality - hospitable
smell - odor
write hastily - scribble
improve, make better - ameliorate
a person who attempts to impress by acting unlike himself - poseur
tiny bits of wood - sawdust
Self-love - narcissism
a stupid, insensitive person - dullard
yield, die - succumb
lazy slow-moving person - sluggard
fail/move/fall clumsily - flop
take in by swallowing - ingest
say or do again several times - reiterate
unoriginal, obtained from another source - derivative
postpone - defer
fluent speaking skillful use of language - eloquence
half-solid lump formed from liquid - clot
person who travels regularly - commuter
measure hoe heavy something is - weigh
rising or falling sharply - steeply
twisting force causing rotation - torque
person who has given help - benefactor
quality of being limited, not extreme - moderation
request - plea
too strong to be defeated - invincible
lasting - enduring
lacking solidarity, strength - flimsy
form of a frog when it leaves the egg - tadpole
trouble disturbance - turmoil
health of mind soundness of judgment - sanity
secret with a hidden meaning - cryptic
brave,behaves well with women - gallant
write one's name on the back of - endorse
porous rubber for washing live at once expense - sponge
changeable inconstant fickle unstable explosive - volatile
to debase by mixing with something inferior - alloy
settle a quarrel restore peace - reconcile
splitting or division (esp. of cells) - fission
keep the memory of - commemorate
a manner of walking, stepping, or running - gait
in a state of inactivity but awaiting development - dormant
A piece of broken pottery - shard
steel tool for shaping materials - chisel
enclose in capsule - encapsulate
trying to please, obliging - complaisant
causing grief or pain, serious dire grave - grievous
falsely making oneself appear to be good - hypocrisy
catalyst - enzyme
get rid of pull up by the roots - eradicate
fill with fury or rage - infuriate
attack verbally - Lambaste
approval (by authority) penalty - sanction
swallow up - engulf
elation state of pleasant excitement - euphoria
celebrated, famous - renowned
involving or using conversation. - colloquial
call up bring out - evoke
harmful, causing mischief - mischievous
implied though, not plainly expressed - implicit
extreme bad - abysmal
show much fondness center one's attention - dote
puzzling person or thing - riddle
one who hates women/females - misogynist
proof to the contrary - disproof
Cruel - sadastic
without preparation - impromptu
directing the mind in a certain direction - inclined
irregular in behaviour or opinion - erratic
giving great attention to details - meticulous
having both of two contrary meanings - ambivalent
belong as a part have reference - pertain
helping, supporting - auxiliary
make tight or smaller - constrict
star, light-giving body - luminary
turned to bone, hardened like bone, Inflexible - ossified
something giving strength or energy - tonic
be destroyed decay - perish
anticipatory fear, premonition - presentiment
not easily heard, seen clearly marked - indistinct
cheat make a fool of - dupe
difficult to comprehend, obscure - abstruse
being uncontrollably violent - turbulence
a person with good judgement (e.g.. in art) - connoisseur
straying away from what is normal - aberration
outside the law - extralegal
destructive thing or a person who is nuisance - pest
sentence within another one something separated - parenthesis
complex, subtle, refined - sophisticated
to cause pain, uneasiness, or trouble to. - ail
lacking strength, walking unevenly - limp
known or understood by very few - arcane
A very small amount, portion, or particle - mite
instruct, correct morally - edify
become strong after illness loss exhaustion - recuperate
satisfy fully - satiate
man owning small estate, middle-class farmer - yeoman
loyalty accuracy - fidelity
pull the feathers off pick (e.g.. flowers) - pluck
willful FALSE statement unlawful act - perjury
a model example or pattern - paradigm
easily gulled - gullible
quality or condition of being sober - sobriety
easily controlled or guided - tractable
written order - writ
hypnotize - mesmerize
have more power than others - predominate
speak distinctly, connect by joints - articulate
number of ships, quick-moving - fleet
of the power of forming a solution - solvent
move force from the place occupied - dislodge
one-sided committed to a party biased or prejudiced - partisan
weapon with a metal point on a long shaft - spear
lively high-spirited - vivacious
mislead or delude, cheat, pass time - beguile
change to a thick and solid state - coagulation
incapable of failure or error - foolproof
free giving, generosity - liberality
worked out with much care in great detail - elaborate
yellow metal (mixing copper and zinc) - brass
spread into every part of - permeate
yielding easily shaped, moldable, adapting - malleable
be enough - suffice
publicly mock or ridicule - lampoon
that cannot be changed - immutable
counterfeit - forgery
regular customer person who gives support - patron
warm and sincere - cordial
receding - retrograde
burdensome, heavy and awkward to carry - cumbersome
cover for the blade of a weapon or a tool - sheath
refuse to accept/cause dislike - repel
unharmed unhurt - unscathed
put something on the top - superimpose
noisy, restraint - boisterous
collapse, bursting inward - implosion
leader of a unit of 100 soldiers - centurion
draw together, unite firmly - knit
of great importance (others depend on it) - pivotal
something that is puzzling - enigma
able to float, light-hearted - buoyant
talk excitedly, utter rapidly - jabber
not to be trusted, perfidious - treacherous
puzzle, confuse - bewilder
walk with long steps - stride
too talkative - garrulous
get back by payment compensate - redeem
metal supports attached to the legs measuring instrument - calipers
hinder, get in the way of - impede
coming back to consciousness - resuscitation
brutal racial discrimination - apartheid
agree in opinion happen together - concur
inclined to indulge - indulgent
a number of performance of music - recitals
try to win - woo
person who hates mankind - misanthrope
tending to evade - evasive
formal praise panegyric - eulogy
nurture, care for - foster
to steal, especially in small quantities - pilferer
make or become pure cultural - refine
skill (esp. in handling) - dexterity
sham, counterfeit, not genuine - bogus
out of place, not in harmony or agreement - incongruous
varied, motley, greatly diversified - multifarious
short piece of humorous writing - skit
causing a feeling of disgust - repulsive
unlucky - hapless
complicated,coiled, twisted - convoluted
not easily exhaustible, tirelessness - indefatigability
To seek favor or attention by flattery and obsequious - fawn
show bodily or mental pain - wince
bitter quarrel over a long period of time - feud
being fully aware of - cognizant
giving facts to support (statement) - substantiation
easy and painless death - euthanasia
angry - irate
make a lower bid then somebody else - underbid
recess/partially enclosed place - alcove
wildly excited with joy, pain, anxiety - frantic
small sin small weakness in one's character - peccadillo
spread through every part of - pervade
order given by authority - decree
invent, prepare by mixing together - concoct
greenish-blue precious stone - turquoise
person who loves wealth and spends little - miser
brave - valiant
insulting, tending to damage - derogatory
lost brightness - tarnished
feeling or showing deep respect - reverent
likely to come or happen soon - imminent
arousing sensual pleasures - voluptuous
prevent from being known put an end to - suppress
final and unalterable - irrevocable
heavy with water - soggy
having a desire to revenge - vindictive
unrestrained, willfully malicious, unchaste - wanton
be too tight take between the thumb and finger - pinch
dishes made of baked clay - earthenware
discover and bring to light - unearth
taste flavor something - savor
mischievous trick played to deceive - hoax
corrosive, sarcastic - vitriolic
talkative, garrulous - loquacious
open disobedience or resistance - defiance
frank, straight-forward - candid
person who stirs up war - warmonger
outburst of feeling, sudden rain wind fire etc. - gust
coming together and uniting into one substance - coalescing
preliminary, anticipating - precursory
forgery - counterfeit
burst out suddenly/talk ardently - gush
state of doubt or perplexity - quandary
loud chuckle of pleasure or amusement - chortle
feeling of regret for one's action - compunction
move quickly suddenly and with force - plunge
have deep respect for - revere
change direction suddenly - swerve
rubbed off, worn away by friction - abraded
Punishing - punitive
person who is slow waste of time - dawdler
harmful - noxious
severe pain or suffering - torment
spend wastefully - squander
to clear from a charge of guilt - exculpate
suppressed, kept back - stifled
direct opposing - antithetical
use until none remains - deplete
by the way - apropos
make payment to reward punish - recompense
compel to force to make obedient - coerce
surgically clean - aseptic
incapable of being placated, unpleasable - implacable
leather case for a pistol - holster
grow reproduce by rapid multification - proliferate
increasing the number, spreading, extending - propagation
pleasing in appearance attractive - personable
granting of privileges in return for similar - reciprocity
watchfulness self-appointed group who maintain order - vigilance
distracted violently upset in mind - distraught
quality of being unskillful - ineptitude
being bright, polished - lustrous
increase in density strength make laconic - condense
to praise highly - extol
prevent by taking action in advance, preempt - forestall
state or put forward as a necessary condition - stipulate
show feeling of great sorrow - lament
make angry vax - provoke
fall plunge steeply - plummet
written order requiring a person to appear in a low court - subpoena
accumulate - accrue
excessive admiration of - idolatry
grasping understanding fear unhappy feeling about future - apprehensive
total rejection of all religious and moral beliefs - nihilism
black powder in smoke - soot
brave - valorous
tending to comply obliging willingness to please - complaisance
unlawful, forbidden - illicit
sticky/semi-fluid - viscous
strong dislike - aversion
arrogant, conceited - haughty
agreement or harmony - concord
present but not yet active, developed or visible - latent
be unsteady and overturn - topple
take the place of - supersede
put into difficulties - entangle
To mark with different shade or colors - variegate
unskillful, said or done at the wrong time - inept
being different in moral standards (from normal) - deviance
pronounce (words)/express a theory - enunciate
a controversial argument / a person engaged in such an argument - polemic
primitive unspoiled pure as in earlier times unadulterated - pristine
something that hinders (e.g. stammer) - impediment
a sheet of floating ice - floe
wishing to do evil - malevolence
common - prevalent
weaken gradually at the base make something under - undermine
steep difficult ascent, laborious - arduous
sluggish, dull, not tight - slack
exercises to develop strong bodies - calisthenics
soothe pacify calm - placate
roof of the mouth, sense of taste - palate
crime of killing a king - regicide
person who attacks popular beliefs - iconoclast
sharpness stinging quality - pungency
reserved, indifferent - aloof
not easily discouraged or subdued - indomitable
delicate way of dealing with a situation - finesse
full of odd and fanciful ideas - whimsical
interfere with - tamper
person who lives alone and avoids people - recluse
make or become silent - hush
person guilty of murder - felon
careful, economical - frugal
keep away from avoid - shun
lying, habitually dishonest - mendacious
give notice to inform - apprise
cloth worn round the neck, silencer - muffler
stubborn, narrow-minded person - bigot
urgent, essential - imperative
take the whole attention, enslave - enthral
burn slowly without flame - smolder
sad, gloomy, miserable - dismal
dangerous - perilous
giving or producing freely liberally or generously - lavish
flow in drops - trickle
having the qualities of a devil - diabolical
forcefulness - vehemence
free from encumbrance - disencumber
imminent, about to happen, expected - impending
person who insists on importance of something - stickler
mark of shame or disgrace - stigma
admit, declare openly - avow
severe punishment - castigation
wish or activity in doing good - benevolence
Constant - incessant
crouch/settle without permission - squat
gratify, give way to satisfy allow oneself - indulge
discourage hinder - deter
skeptical, unwilling to believe - incredulous
firmness persistency adhesiveness tending to hang on - tenacity
state of growing vigorously being full of life - exuberance
one who abandons long-held religious or political convictions - apostate
the point general sense - gist
temporary fleeting - transient
suggestion in addition to - connotation
impress deeply - engrave
scold sharply - berate
reconciling, soothing, comforting, mollifying - conciliatory
overcome bring under control - subdue
rise fly high - soar
relying on experiment - empirical
keeping on putting off - procrastination
bunch of threads - tassel
pure, faultless - immaculate
clever quick at seeing to get an advantage - astute
show off complacently - flaunting
worsen, diminish in value - impair
prostrate, inclined to (undesirable things) - prone
shy/modest (especially of a girl) - coy
plunder (especially in war) - pillage
cannot be cured or corrected - incorrigibility
cheerful person - extrovert
approval - approbation
rub or wipe out, obliterate - efface
unspoken, silent - taciturn
make calmer or quieter - mollify
much too high or great - exorbitant
self-controlled - sober
(agreement) stop of fighting for a time - truce
convincing firm belief - conviction
give greatly needed support - bolster
rules establishing standards of conduct - precepts
to chastise, correct by punishing - castigate
make shorter then was planned - curtail
based on error - fallacious
To take in marriage - espouse
not having interest - nonchalant
brightly colored, florid - flamboyant
eat greedily/narrow opening with a stream - gorge
annoy distress trouble - vex
using pompous words - grandiloquent
large piece of cloth - poncho
unmoved, feeling no sign of passion - impassive
covered hole as a trap unsuspected danger - pitfall
treat with care and tenderness - coddle
incapable of being discovered or understood - inscrutable
sharp, piercing - shrill
of connected with trees - arboreal
crude, rude - boorish
become quiet or less active - lull
fearful timid afraid - timorous
calm not capable of being excited - imperturbable
take up a high position - perch
careful forethought - prudence
a group or band of people - cohort
having sound judgment, perceptive, wise like a sage - sagacious
not noble, inferior - ignoble
place here and there - intersperse
unaware, having no memory - oblivious
repeal/annul/cancel - rescind
cloud-like, hazy, vague, indistinct - nebulous
distribute (esp. ideas) - disseminate
attention/give notice to - heed
expressing or giving praise - laudatory
in enjoy warmth and light - bask
lucky, stroke - fluke
overflowing with enthusiasm showing excitement - ebullient
easily bent - pliant
making dear or liked - endearing
uncertain risky dangerous - precarious
hell - inferno
tremble beat rapidly and irregularly - palpitate
make beautiful - embellish
threatening - ominous
make nervous or confused - fluster
be admitted enter a university as a student - matriculation
sensitiveness - susceptibility
touch or scrape lightly in passing - graze
suppress subdue - quell
make known something secret - divulge
feeling doubt - dubious
misuse of a word (for one that resembles it) - malapropism
rebel, nonconformist - maverick
irritable, easily angered - irascible
engrave, make a cut in - incise
shut out from society refuse to meet talk - ostracism
extremely pleasing to taste - ambrosial
step to one side - sidestep
obtain by threats violence - extort
to resist separation - cling
brief summary representative example a typical model - epitome
a complex ornate design - arabesque
savage cruelty - ferocity
bad-tempered/quarrelsome - cantankerous
pure - chaste
additional strengthening evidence - corroboration
to remove obscenity purify censor - expurgate
unconscious, unresponsive, unaffected - insensible
to gather and save to store up - garner
move restlessly make nervous - fidget
not allowing to pass through (of materials) - impervious
split crack dissension - rift
production of a desired result - efficacy
To bring about - Conduce
bring into harmony - attune
call together summon - convoke
hatred being an enemy - enmity
ready to believe things - credulous
can be felt or touched - palpability
address a court of law as an advocate - plead
Existing in a wild or untamed state - feral
a person who is devoted to eating and drinking to excess - gourmand
diseased, unhealthy (e.g.. about ideas) - morbid
more then is needed or wanted - superfluous
equal distribution of weight equilibrium - equipoise
change direction - veer
kind and gentle - benign
(of eyes) dull - lackluster
punishment - chastisement
opening, broken place, breaking - breach
to make thin to make less dense to purify or refine - rarefy
have a different opinion refuse to assent - dissent
person who has been converted to a belief - neophyte
uncommunicativeness - reticence
dutiful to parents, devoted to religion - pious
walk heavily - trudge
care economy thriving prosperous - thrift
intimidate make fearful - daunt
regard with deep respect - veneration
serious requiring, consideration - grave
frantic, frenzied - frenetic
untidy - disheveled
showing self-control - temperate
lack of reverence or dutifulness - impiety
bored with pleasure or dissipation - blasé
hot enough to boil - scalding
hesitating, undecided - irresolute
act with excessive enthusiasm - rave
belief contrary to what is generally accepted - heresy
deceit, cunning - guile
worry, irritation, wear away - fret
legal trickery/false argument - chicanery
That gives warning or information - telltale
lacking purpose or vitality ineffective careless - feckless
enthusiasm - ardor
a breakup overthrow sudden disaster - debacle
cheap gaudy showy tacky - tawdry
striped grooved or banded - striated
meant as a joke - jocular
set someone clear (e.g.. from blame) - exoneration
argumentative pugnacious combative quarrelsome - contentious
use flattery or deceit to persuade - cajole
quality of quickly recovering the original shape - resilience
look on with contempt - disdain
contemptuous reproach hurtful remark - taunt
eager and cheerful, readiness - alacrity
suspended action - abeyance
deification glorification to godliness - apotheosis
trick, mislead - hoodwink
weak/unsteady light - glimmer
brief and to the point - terse
situated beyond - ulterior
notched - jagged
very great number - myriad
defying, imitation, unmatchable - inimitable
a riddle dilemma enigma - conundrum
stir up, rouse - incite
waver/move in an uncertain manner - falter
slow way of speaking - drawl
shout complain with a lot of noise - clamor
a connection or link - nexus
deliver provide represent - render
come to grips/settle conclusively - clinch
help/encourage somebody (in doing wrong) - abet
propriety properness - decorum
state of being passive/motionless - quiescence
careful/prudent - discreet
fermented alcoholic beverage similar to but heavier than beer - ale
long strip worn round the waist - sash
violent cruel man - ruffian
lukewarm - tepid
to travel from place to place to peregrinate - itinerate
dismal, mourful - doleful
causing no harm - innocuous
complete, thorough - exhaustive
repeal or annul by authority - abrogate
take back as being FALSE give up - recant
press lose shape subdue overwhelm - crush
claw of a bird of prey - talon
person dishonestly claiming to something - quack
make thin and weak - emaciate
break off - sever
soaked, saturated - sodden
Poisonous, noxious - mephitic
shortly, roughly, quickly - sketchy
fearless, brave, undaunted - intrepid
not normal or usual - preternatural
an outcast a rejected and despised person - pariah
not pretended sincere - unfeigned
like a slave lacking independence - servile
to turn to bone to settle rigidly into an idea - ossify
neat, formal - prim
(adj) boorish - churlish
stare at - fixate
having plenty of space for what is needed - commodious
draw, move back, wince - flinch
rising of people to open resistance to - insurrection
cast or fashion anew - recast
obstruct/frustrate - thwart
break go beyond (a limit) - transgress
taken up all the time or attention writing in large or formal - engrossing
slander say evil things - vilify
unwillingness to compromise stubbornness intractability - intransigence
disguised - covert
odious (of crime) - heinous
put, pour, fill - infuse
present everywhere - ubiquitous
fanciful, fantastic, imaginary - quixotic
noisy, quarrel - fracas
becoming rotten - putrefaction
dull and slow - torpid
make something (pain desire) less - assuage
suggest unpleasantly, make a way for something gently - insinuate
person who flatter to the rich and powerful - sycophant
elegant refined in manners - urbane
exuberance outburst of feeling - ebullience
severely moral and strict simple and plain - austere
not paying proper attention - inadvertent
attack violently - assail
spending using unwillingly - stingy
having a double or doubtful meaning, suspicious - equivocal
inclination - proclivity
crouch shrink back - cower
bowl-shaped vessel with many holes used to drain off water - colander
hurt by rough handling - maul
of the present time only - provisional
to polish, rub to a shine - burnish
extreme poverty - penury
a song of grief or lamentation - dirge
anger - ire
without use result conceited - vain
reddish, healthy-looking - ruddy
suffer the loss of something - forfeit
cause produce give rise to - engender
blocked up - occluded
rich and deep, plump and round - rotund
childish - puerile
person of great learning - savant
abundant/lavish - profuse
weaken deprive of strength attenuate - enervate
kind of stone, inflexible - adamant
a generator something that produces electric current - dynamo
try to deceive by equivocal language - equivocate
waste away, bite steadily - gnaw
to turn away (from a habit) - wean
get something inquire too curiously - pry
to bless, make happy or ascribe a virtue to - beatify
distinct - discrete
predominance - hegemony
supply to much fill to excess - glut
line made by crushing white line on the ground in cricket - crease
get to know - ascertain
to venture - foray
honest, straightforward - guileless
something sharp - sting
join (two ends) - splice
feeling or showing regret - penitent
a lament a melancholy composition - elegy
reserved, untalkative, silent, taciturn - reticent
cowardly, craven - pusillanimous
blunt/stupid - obtuse
scarcity a lacking of - paucity
following, attendants - retinue
bitter and violent attack in words - diatribe
think deeply mediate - cogitate
perfect/make, perfect/complete - consummate
showing no emotion impassive - stolid
boldness impudence arrogance - effrontery
disintegration looseness in morals - dissolution
ridicule mockery deriding - derision
laziness - indolence
large pile of wood for burning - pyre
learned, scholarly - erudite
quick changeable in character fleeting - mercurial
physical of or for the body - corporeal
commonplace trite unremarkable - pedestrian
steady, regular - equable
containing warning - admonitory
easily understood, lucid, clear - luculent
of the same period, coexisting - coeval
narrow-mindedness, isolated - insularity
favorable successful prosperous - auspicious
material (not spiritual) living outside monasteries - secular
long thin move very fast - streak
coming into existence, emerging - nascent
disapprove of - decry
strong inclination a liking - penchant
Physical beauty - pulchritude
responsilibilty,burden - onus
conquer - vanquish
to destroy exterminate cut out exscind - extirpate
diligent hard-working, sedulous - assiduous
hardship - privation
the growing of separate things into one - accretion
eagerly desirous - covetous
(v) to embezzle or misappropriate - defalcate
causing harm or ruin, pernicious, destructive - baneful
that cannot be rubbed out - indelible
lessen the severity of - palliate
strong, convincing - cogent
shortage - dearth
transparent easy to understand - pellucid
forgive - condone
move in a clumsy/noisy way - lumber
refuse to believe - discredit
relapse into antisocial or criminal behavior - recidivism
be out of view ready to attack - lurk
passage that completes a piece of music - coda
abundant supply - cornucopia
surface appearance covering the TRUE nature - veneer
to make hard rocklike - petrify
expression of blame or disapproval a rebuke - censure
draw out - elicit
having a toothed edge - serration
pretty/delicate(food)/difficult to please - dainty
biting sarcastic - caustic
(person) with superior tastes - highbrow
repulsive, hateful - odious
promise or swear to give up - abjure
a blindly devoted patriot - chauvinist
a beginner - tyro
silly, senseless - inane
speak comprehensively become wider large - dilate
make morally bad,corrupt - deprave
blacken, belittle, sully, defame - denigrate
deliberate deception - duplicity
prolonged - protracted
tightly stretched - taut
muddy having the sediment stirred up - turbid
an inexperienced person. - fledgling
Meticulous - punctilious
inclined to fighting - bellicose
shameful, dishonorable, undignified, disgraceful - ignominious
as an installment - interim
eager, greedy - avid
very much ornamented naturally red (e.g.. of face) - florid
to speak harmful untruths about someone - malign
flood cover by overflowing - inundate
make thin, weaken, enervate - attenuate
get to the end of - consume
calm, sluggish, temperament, unemotional - phlegmatic
self-righteousness hypocritical with FALSE piety - sanctimony
harmful or unfriendly - inimical
to equivocate to stray from the truth - prevaricate
naive, young, artless, frank, honest, sincere - ingenuous
truth - veracity
not good enough, unable to have young ones without value - barren
flat metal on a wall as a memorial - plaque
legal claim until a debt on it is repaid - lien
emergency an urgent situation - exigency
vexation - chagrin
affirm, assert, prove, justify - aver
too great a readiness to believe things - credulity
treat with contempt - snub
statement that damages reputation - libel
patience, willingness to wait - forbearance
fluency verbosity easy use of spoken language - volubility
over-high opinion of too much pride - conceit
personal mannerism - idiosyncrasy
hardened and unrepenting, stubborn, inflexible - obdurate
no use person something that fails - dud
easily done - facile
touching neighboring near - contiguous
insubstantial/dull/immature - jejune
scent waving movement carry lightly through - waft
unresistant, submissive - resigned
border on - abut
to practice deception or fraud, scheme. - finagle
disown refuse to accept or pay - repudiate
a signal, especially of alarm - tocsin
appearing TRUE or real - verisimilitude
edge ornamental border part of hair over the forehead - fringe
corrected punished - chastened
of the body - somatic
harmful, injurious - pernicious
worthless, outside part of anything - husk
without taste or flavor - insipid
get somebody to do something by kindness - coax
stupid fellow - dolt
poor/stingy - penurious
negotiation - parley
outflow in a stream of particles a noxious odor or vapor - effluvia
a raid, a sudden attack - incursion
to darken, make obscure, muddle - obfuscate
prevent make impossible - preclude
sophisticated artful trying to deceive cunning - disingenuous
burden things that get on the way of - encumbrance
to be established accepted or customary - obtain
ill-tempered, unsocial - morose
over look at with selfish delight - gloat
habit or action peculiar to something - quirk
without previous thought or preparation - extempore
essentially different - disparate
to delight or entertain to feast - regale
become discolored/dry up/go at high speed - scorch
be guilty commit (a crime) - perpetrate
prevent from carrying out - foil
healthful - salubrious
to fake illness or injury in order to shirk a duty - malinger
Complain or grumble (verb) - grouse
Obvious - Palpable
see with an effort but clearly - discern
talk vaguely and without much result - waffle
brief - transitory
done as a duty without care - perfunctory
pedant authority on a subject - pundit
still in existence - extant
worldly as opposed to spiritual commonplace everyday - mundane
great flood heavy rush of water - deluge
of the internal organs of the body - visceral
causing tears, tearful - lachrymose
consider to be the origin of or belonging to - ascribe
to be stained or discredited - sullied
to cut out cut away - exscind
boldness brashness intrepidness - temerity
reduce the strength of lessen seriousness partially excuse - extenuate
crawl, humble oneself - grovel
secret agreement for a deceitful purpose - collusion
foul filthy - squalid
to move in wavelike fashion fluctuate - undulate
too tired - fagged
astute, showing sound judgement - shrewd
not soled with hole - hollow
One that indicates or foreshadows what is to come, a forerunner. - harbinger
majestic, venerable - august
easily seen remarkable - conspicuous
A Christian feast celebrating the manifestation of the divine nature of Jesus to the Gentiles as represented by the Magi. - epiphany
widespread - rife
to show clearly to indicate - evince
work (usually artistic) which imitates - Pastiche
socially awkward, tactless behavior - gaucherie
trap - snare
feeling bitterness, spitefulness - rancorous
too fussy about food clothing etc. - finical
sweetly flowing - mellifluous
gruesome, suggesting death - macabre
rough awkward - uncouth
end (a debt) by setting aside money - amortize
to make unnecessary get rid of - obviate
lack of seriousness - levity
practicing self-denial, austere, stark - ascetic
to portray depict sketch out - delineate
song of praise or triumph - paean
lowest, weakest point - nadir
stir up excite - emote
warmth of feelings earnestness - fervor
make or become stiff and solid - congeal
spirit vigor enthusiasm - verve
hence, awkward - gauche
move along with long strides - lope
argue earnestly to dissuade correct or protest - expostulate
speech lecture - discourse
treat as a famous person - lionize
a lover of an art or science - dilettante
offensive, disgusting (smell) - noisome
discuss lightly or glibly, exchange (words) heatedly - bandy
positive certain arbitrary without room for discussion - dogmatic
devoted to pleasure (sensuous enjoyment) - epicurean
magnificent - sumptuous
cowardly - craven
weariness, tiredness - lassitude
display to obtain admiration or envy - ostentation
cheerful, confident, optimistic - sanguine
tiresome - irksome
wasteful, reckless with money - prodigal
hasty rush, cheeky, saucy - brash
repay give in return - requite
commanding, haughty, arrogant - imperious
intended to instruct - didactic
warning sign - presage
being immature - sophomoric
unimportant - trifling
male bee person who isn't self-employed - drone
fresh and green - verdant
To settle (oneself) securely or comfortably - ensconce
uncompromising - intransigent
enormous, wonderful - prodigious
magnificent - palatial
eager/excited - agog
substance used to absorb moisture - desiccant
a smug ignorant person one who lacks knowledge - philistine
bring up, announce, begin to talk about - broach
a trick - wile
recreant, protestant,skeptic - heretic
lying on the back slow to act passive - supine
opposing progress - reactionary
person who tells anecdotes - raconteur
substance become excited - ferment
feeling of doubt temporary feeling of sickness - qualm
haughtiness - hauteur
treacherous, faithless - perfidious
a decorative chain or strip hanging between two points - festoon
make rough - rumple
auspicious, presenting favorable circumstances - propitious
to protest object - remonstrate
call calling of names - roll
bad-tempered person - curmudgeon
arrangement to give something at death - bequest
not yet fully formed, rudimentary, elementary - inchoate
humorous, funny, jocular - facetious
without sense foolish, self-satisfaction - fatuous
scold upbraid - reproach
looking ill, not bright - wan
greedy (esp for money) - rapacious
to hinder obstruct or block - stymie
harmful, ominous causing evil - baleful
projecting, prominent, undesirably noticeable - obtrusive
tidy/show self-satisfaction - preen
gibe, make fun of - jibe
that can be freed - extricable
carved image on the prow of a ship - figurehead
blessing - benison
frugal, looking to the future - provident
fix take up secure metal pin - rivet
artificial obstacle built across a river - barrage
stinking - fetid
grow forth send out buds - burgeon
presumptuously, arrogant, overbearing - overweening
refuse to approve of - discountenance
being uncertain hesitating - vacillation
avoid - eschew
bookish showing off learning - pedantic
having sudden energy, impulsive - impetuous
dejected - rueful
calmness of temperament - equanimity
arrogant, pride - hubris
block, halt, stop - kibosh
a beggar - mendicant
producing sleep - soporific
repayment death of Jesus - atonement
shallow place in a river (to cross) - ford
renounce, disallow, repudiate - forswear
severe criticism - excoriation
make or become soft by soaking in water - macerate
make a humble petition to - supplicate
gloomy, dark, sullen, morose - saturnine
small boat - skiff
To hesitate as if in fear or doubt - boggle
depth - profundity
cheerful, casual, carefree - blithe
join sounds/words (indistinct) - slur
to scorn or despise - contemn
polite manner, comforting, uninteresting - blandness
closing device (in Parliament) to end a debate by voting - cloture
to make holy, consecrate - hallow
devious/not straightforward - tortuous
way out exit - egress
sheath for the blade - scabbard
use extravagant language - rant
idleness - vacuity
deserting and leaving to fall into ruins - dereliction
like a seed constituting a source, originative - seminal
like a rock hard stony - petrous
easily shocked, excessively modest - prudish
dishonesty - mendacity
plot, scheme (esp. evil) - machination
refusing to move reluctant to be controlled - restive
quick judging and understanding - perspicacity
to entangle the state of affairs - labyrinthine
abstruse intended only for a small circle of - esoteric
treachery breaking of faith - perfidy
ask earnestly - entreat
dried plum silly person - prune
official duties - incumbents
filled with deep sorrow for wrongdoing - contrite
tactless, clumsy - maladroit
uprightness incorruptibility principle - probity
chains for the hands or feet - manacle
poverty - indigence
showing earnest feeling - fervid
complicated and embarrassing situation - imbroglio
describe somebody scornfully - stigmatize
lose hair/feathers before new growing - molt
examine thoroughly to learn about the condition - overhaul
relevant, pertinent to - germane
illogical of questionable truth or merit - specious
something urging a person to action - goad
trace or sign - vestige
piece of linen worn as a necktie - cravat
circular or spiral movement (e.g.. of wind) - eddy
line (of police acting as a guard) - cordon
food for horses and cattle - forage
deeply moving keen - poignant
plundering - depredation
pale yellow (hair) a plant - flax
too economical, miserly - parsimonious
brilliant achievement develop use selfishly - exploit
include under a rule - subsume
one who considers himself smarter than others - aleck
unreasonably, impatient - petulant
red and healthy - rubicund
severing - severance
certain, inevitable - ineluctable
a trite or banal statement unoriginality - platitude
mournful, excessively sad - lugubrious
unconcerned, carefree - insouciant
calm and peaceful - halcyon
too eager or ready to help offer advice - officious
tool for cutting grooves in wood - gouge
prohibit forbid - interdict
needing effortl burdensome - onerous
special liking mental preference - predilection
reject mock to go against (as in going against tradition) - flout
person appealing not to reasons - demagogue
(person nation) waging war - belligerent
cautious, wary - chary
pretend - feint
wasteful prodigal licentious extravagant - profligate
to attribute to a cause or source ascribe - impute
scold reproach - upbraid
a scheme or plot a group of plotters - cabal
protest against, express disapproval of - deprecate
too eager to obey or serve - obsequious
deep-rooted. long-established - inveterate
check hinder - retard
false, counterfeit - spurious
conciliatory, appeasing, mitigating - propitiatory
sentimental in a silly or tearful way - maudlin
send from one track to another lay aside evade discussion - shunt
self-confidence - aplomb
melodious, harmonious - dulcet
a repetition a redundancy - tautology
accustomed to adapted - inured
deserved and unavoidable punishment for wrong doing - nemesis
living in societies liking the company - gregarious
an outcome or solution, the unraveling of a plot - denouement
stone used for sharpening tools - hone
quick, hurried - cursory
workshop for the shaping of metal to shape metal lead - forge
having little or no money - impecunious
wretched, comfortless, contemptible - sordid
jargon, slang - argot
glut - plethora
winding, undulating serpentine - sinuous
member of a vigilance committee - vigilant
immoral person - libertine
aimless,haphazard, digressing at random - desultory
nearness in time or place affinity of nature - propinquity
obscene - salacious
omen, sign - augury
a long passionate speech - harangue
intense hatred or dislike - odium
excessively ornate swollen or bloated - turgid
disobedient - recalcitrant
to distress, create stress or torment - harrow
to deprive (someone) of something, as by fraud, extortion, etc. - mulct
act of preaching - homiletics
Great brilliance, as of performance or achievement - eclat
defect of character (a person is wrongly proud) - foible
letter - epistle
dethronement, depositing - deposition
fix firmly by repetition - inculcate
suddenly changeable - tangential
to deny, to oppose - gainsay
fairly good but not very good - middling
counterbalance - countervail
open to discussion or debate, doubtful - moot
A stock of plays, dances, or pieces that a company or a performer knows or is prepared to perform - repertoire
not any, no, - nary
An alloy of zinc and copper used as imitation gold, A cheap imitation - pinchbeck
extremely loud and powerful - stentorian
finical - finicky
to frequently visit - resort
worldly having contempt for God - profane
taking off getting rid of giving up - divestiture
soft light, delicate material - gossamer
bad-tempered person - churl
abstinence from alcohol self-control moderation - temperance
aggressiveness ferocity - truculence
to attack verbally, denounce, deprecate - inveigh
shyness - diffidence
something reverting to an earlier type - atavistic
formal reception/embankment - levee
substance that shrinks - astringent
wrinkle - pucker
alarm excited state of mind - trepidation
showing scorn or reproach - opprobrious
transparent, gauzy - diaphanous
trifling/worthless - nugatory
snub - rebuff
distracted - distrait
insubstantial flimsy weak - tenuous
diminishing or lessening of swelling - detumescence
gather facts in small quantities - glean
dig up from the earth - disinter
lower the quality weaken the strength - vitiate
like a man who pays too much attention to his clothes - foppish
formal praise eulogy - panegyric
criticism, anti-aircraft guns - flak
to be divided or subdivided to branch out - ramify
continue doing something without resting - plod
stubborn, unmanageable, intractable - refractory
fertile - fecund
warm or glowing praise eulogy panegyric - encomium
likely to be useful for a purpose - expedient
fond of in the habit of fighting - pugnacious
curse abuse in words - vituperate
forceful effective vigorous extremely perceptive incisive - trenchant
upset the self-possession of - disconcert
lose courage turn frightened - quail
abusively, detractive language, sharp criticism, vituperation - obloquy
confuse embarrass - discomfit
rash, indiscreet - impudent
drink deeply - quaff
unfortunate inconvenient - untoward
reproving a person for his faults - sermon
fluent - voluble
extreme, astounding - sublime
mob crowd the lower classes of populace - rabble
slander, aspersion - calumny
urgent, imperative, unchallenged, ending debate - peremptory
a supporting bar - strut
flattery, coaxing - blandishment
insincere talk/jargon - cant
rob or dispossess of something (material) - bereft
to shackle put in chains - fetter
straightforward., lacking in imagination and spirit - prosaic
wickedness shamefulness - turpitude
ready and smooth but not sincere - glib
showing vulgar in nature or appearance, tawdry - raffish
flag/badge - ensign
insubordinate rebellious - contumacious
roughness, harshness, ill temper, irritability - asperity
attractive on the surface but of little value - meretricious
(give a) silly/self-conscious smile - simper
a carefree episode or experience - idyll
oppose to alcohol - teetotal
make angry - incense
real rightly named - veritable
abusive language, curses - invective
demeanor - mien
to be involved - implicate
epidemic - endemic
hairy, shaggy - hirsute
easy-going trifle - unencumbered
fallacious, reasoning faulty logic - sophistry
challenged to be doubted - impugned
satiate feed to fulness or to excess - surfeit
banal, everyday - quotidian
offense resentment - umbrage
the stage setting or scenery of a play - miseenscene
suitably expressed, well chosen, apropos - felicitous
cut roughly, hired horse - hack
obsequious flatterer - toady
traveling about wandering - peregrination
quality of endurance or courage - mettle
to great to be described in words - ineffable
representing the whole Christian world - ecumenical
beginning - incipient
discuss thoroughly sort of touting - canvass
mournful, melancholy, sorrowful - plaintive
waste away through sorrow or illness - pine
seeming appearing as such professed - ostensible
To solicit customers, votes, or patronage - tout
agreeably pungent, stimulating - piquant
tap or drive down by repeated light blows - tamp
refrain from, be patient, ancestor - forbear
king of blue-grey stone, propose, criticize - slate
menacing, threatening - minatory
to stop the flow of a fluid - stanch
able to fly trained experienced - fledged
get to the root of - plumb
showing respect - deferential
various miscellaneous, separate - sundry
paint with dots - stipple
noisy and rough - blatant
slander - aspersion
to hesitate, raise objections - demur
surprise and fear, dismay - consternation
have nothing to do reject or refuse - spurn
to beg, to get by begging - cadge
to adorn especially in a cheap showy manner - bedizen
provide supply - purvey
cessation of use disuse - desuetude
asking humbly beseeching - suppliant
arrogance - presumption
Cheap and showy - brummagem
to favor or approve of - countenance
beat hard - belabor
noisy, loud - obstreperous
formidable causing fear - redoubtable
obstacle purposely to get on the way of - balk
disdainful characterized by haughty scorn - supercilious
not new - trite
a loud domineering woman a scold or nag - virago
hence, dark, gloomy - stygian
puzzle in which pictures stand for words - rebus
prayer - orison
greatness in number strength weight - preponderance
person hardened in sin, one devoid of decency - reprobate
sealed by fusion - hermetic
ending, expiring - expiation
strange act or idea - vagary
short and pithy full of maxims/proverbs - sententious
person who eats a lot - trencherman
make by hard work cut (by striking) - hew
denounce as dangerous - proscribe
speak or behave so as to hide something (in mind) - dissemble
omen marvelous threatening - portent
not permitting penetration or passage, impenetrable - imperviousness
involving clever rogues or adventurers - picaresque
Covered with hair - pileous
ready to do something dishonest - venal
trivial poorly constructed verse - doggerel
bad-tempered,irritable - splenetic
wandering - peripatetic
an invocation of evil a curse - imprecation
intractable not willing to yield or comply stubborn - froward
shameless immorality - profligacy
bending, twisting - lithe
courageous, high-spirited - mettlesome
taken away power (to think feel act) - petrified
assistance relief in time of distress - succor
disgusting offensive due to excessiveness - fulsome
discover by searching search - ferret
parody/imitation - travesty
threats to compel somebody - duress
strength - puissance
effete no longer fertile, worn out - acarpous
of mixed colors - pied
infertile, worn out, weak - effete
voracious, devouring - edacious
compel - constrain
nickname - sobriquet
to go proceed - wend
bitter protest - fulmination
show some inclination to accept (an offer) - nibble
heavy, bulky, dull - ponderous
to tolerate, endure - brook
To flatter, to cajole - palaver
hurt the pride or self-respect stir (curiosity) - pique
to assuage to satisfy allay - slake
remedial wholesome causing improvement - salutary
slandering verbal attack aspersion - detraction
turmoil a bewildering jumble - welter
meal - repast
to awaken or rouse - abraid
a quack remedy, an untested cure - nostrum
to be thrifty to set limits - stint
essential part force soft liquid substance - pith
induce by bribery or something to commit perjury - suborn
greatly surprised - nonplused
shining, brilliant - refulgent
to roam wander freely - expatiate
bombastic - fustian
make unfair selection from facts - garble
little known, abstruse - recondite
mean, contemptible - scurvy
pronounce or speak affectedly euphemize - mince
adjective - epithet
persevering - sedulous
tiring because too long - prolix
beg urgently solicit (of a prostitute) - importune
complex - involute
bulge, the protuberance of a cask - bilge
a procession - cavalcade
make hard and without feeling - sere
jesting - droll
catch sight of see something in the distance - descry
made of brass - brazen
at be discontented with - repine
paint portray - limn
merry person - wag
write in scholarly fashion - lucubrate
sparkle - coruscate
without refinement or sensitivity, gross. - crass
pompous self important - consequential
put something warm (to lessen the pain) - foment
witness/evidence - testiness
cowardice a cowardly giving up - recreancy
in the highest degree - arrant
try to avoid by sophistication - quibble
a hasty escape, flight. - lam
marked by the characteristics of an earlier period - Archaic
to consume (liquids) by drinking, drink - imbibe
rest,sleep - repose
performed merely as a routine duty, hasty and superficial - perfunctorily
a position or situation from which there is no escape, deadlock - impasse
physically beautiful, comely. - pulchritudinous
good digestion - eupeptic
deception - Chicane
gigantic - brobdingnagian
a going out, a departure - Exodus
response - Rejoinder
taken,done - Furtive
